cod_ibge;municipio;ano;pop_urb;pop_rur;pop_tot;grau_urb
3500105;Adamantina;2000;30356;3128;33484;90,66
3500204;Adolfo;2000;3068;612;3680;83,37
3500303;Aguaí;2000;24664;3481;28145;87,63
3500402;Águas da Prata;2000;6072;1055;7127;85,2
3500501;Águas de Lindóia;2000;15420;725;16145;95,51
3500550;Águas de Santa Bárbara;2000;3868;1342;5210;74,24
3500600;Águas de São Pedro;2000;1881;0;1881;100
3500709;Agudos;2000;30668;1791;32459;94,48
3500758;Alambari;2000;2442;1205;3647;66,96
3500808;Alfredo Marcondes;2000;2671;1024;3695;72,29
3500907;Altair;2000;2548;979;3527;72,24
3501004;Altinópolis;2000;12532;2931;15463;81,05
3501103;Alto Alegre;2000;3021;1245;4266;70,82
3501152;Alumínio;2000;13713;1524;15237;90
3501202;Álvares Florence;2000;2658;1664;4322;61,5
3501301;Álvares Machado;2000;20061;2561;22622;88,68
3501400;Álvaro de Carvalho;2000;2431;1668;4099;59,31
3501509;Alvinlândia;2000;2428;406;2834;85,67
3501608;Americana;2000;181867;433;182300;99,76
3501707;Américo Brasiliense;2000;27552;644;28196;97,72
3501806;Américo de Campos;2000;4388;1206;5594;78,44
3501905;Amparo;2000;43286;17019;60305;71,78
3502002;Analândia;2000;2646;930;3576;73,99
3502101;Andradina;2000;50811;4323;55134;92,16
3502200;Angatuba;2000;13226;6050;19276;68,61
3502309;Anhembi;2000;3257;1267;4524;71,99
3502408;Anhumas;2000;2506;903;3409;73,51
3502507;Aparecida;2000;34366;522;34888;98,5
3502606;Aparecida d'Oeste;2000;3666;1270;4936;74,27
3502705;Apiaí;2000;16642;10511;27153;61,29
3502754;Araçariguama;2000;7208;3896;11104;64,91
3502804;Araçatuba;2000;164287;4800;169087;97,16
3502903;Araçoiaba da Serra;2000;13639;6119;19758;69,03
3503000;Aramina;2000;4139;617;4756;87,03
3503109;Arandu;2000;4019;2041;6060;66,32
3503158;Arapeí;2000;1897;718;2615;72,54
3503208;Araraquara;2000;173349;8891;182240;95,12
3503307;Araras;2000;97698;6326;104024;93,92
3503356;Arco-Íris;2000;1070;1097;2167;49,38
3503406;Arealva;2000;5242;1998;7240;72,4
3503505;Areias;2000;2450;1147;3597;68,11
3503604;Areiópolis;2000;8558;1735;10293;83,14
3503703;Ariranha;2000;6868;592;7460;92,06
3503802;Artur Nogueira;2000;30318;2647;32965;91,97
3503901;Arujá;2000;56389;2544;58933;95,68
3503950;Aspásia;2000;1177;687;1864;63,14
3504008;Assis;2000;83277;3858;87135;95,57
3504107;Atibaia;2000;96642;14391;111033;87,04
3504206;Auriflama;2000;11882;1624;13506;87,98
3504305;Avaí;2000;3197;1400;4597;69,55
3504404;Avanhandava;2000;8092;728;8820;91,75
3504503;Avaré;2000;72236;4076;76312;94,66
3504602;Bady Bassitt;2000;10207;1268;11475;88,95
3504701;Balbinos;2000;1061;251;1312;80,87
3504800;Bálsamo;2000;6333;1001;7334;86,35
3504909;Bananal;2000;7183;2524;9707;74
3505005;Barão de Antonina;2000;1649;1147;2796;58,98
3505104;Barbosa;2000;4872;961;5833;83,52
3505203;Bariri;2000;26016;2171;28187;92,3
3505302;Barra Bonita;2000;34490;949;35439;97,32
3505351;Barra do Chapéu;2000;1448;3398;4846;29,88
3505401;Barra do Turvo;2000;2876;5222;8098;35,51
3505500;Barretos;2000;98780;5049;103829;95,14
3505609;Barrinha;2000;23888;262;24150;98,92
3505708;Barueri;2000;207372;0;207372;100
3505807;Bastos;2000;17028;3545;20573;82,77
3505906;Batatais;2000;48218;2823;51041;94,47
3506003;Bauru;2000;309881;5612;315493;98,22
3506102;Bebedouro;2000;69897;4846;74743;93,52
3506201;Bento de Abreu;2000;1948;446;2394;81,37
3506300;Bernardino de Campos;2000;9320;1393;10713;87
3506359;Bertioga;2000;28918;853;29771;97,13
3506409;Bilac;2000;5367;715;6082;88,24
3506508;Birigui;2000;90823;3275;94098;96,52
3506607;Biritiba Mirim;2000;20716;3863;24579;84,28
3506706;Boa Esperança do Sul;2000;10734;1817;12551;85,52
3506805;Bocaina;2000;8525;894;9419;90,51
3506904;Bofete;2000;5218;2120;7338;71,11
3507001;Boituva;2000;32416;1824;34240;94,67
3507100;Bom Jesus dos Perdões;2000;11191;2084;13275;84,3
3507159;Bom Sucesso de Itararé;2000;1948;1273;3221;60,48
3507209;Borá;2000;623;172;795;78,36
3507308;Boracéia;2000;3280;456;3736;87,79
3507407;Borborema;2000;10842;2341;13183;82,24
3507456;Borebi;2000;1473;454;1927;76,44
3507506;Botucatu;2000;103818;4306;108124;96,02
3507605;Bragança Paulista;2000;110856;13910;124766;88,85
3507704;Braúna;2000;3415;967;4382;77,93
3507753;Brejo Alegre;2000;1779;527;2306;77,15
3507803;Brodowski;2000;16252;852;17104;95,02
3507902;Brotas;2000;16086;2752;18838;85,39
3508009;Buri;2000;13630;3965;17595;77,47
3508108;Buritama;2000;12625;1218;13843;91,2
3508207;Buritizal;2000;2904;771;3675;79,02
3508306;Cabrália Paulista;2000;3985;663;4648;85,74
3508405;Cabreúva;2000;25625;7301;32926;77,83
3508504;Caçapava;2000;66651;9376;76027;87,67
3508603;Cachoeira Paulista;2000;21638;5526;27164;79,66
3508702;Caconde;2000;11810;6557;18367;64,3
3508801;Cafelândia;2000;13053;2736;15789;82,67
3508900;Caiabu;2000;3113;962;4075;76,39
3509007;Caieiras;2000;68100;2725;70825;96,15
3509106;Caiuá;2000;1765;2418;4183;42,19
3509205;Cajamar;2000;47901;2667;50568;94,73
3509254;Cajati;2000;20959;8217;29176;71,84
3509304;Cajobi;2000;8352;818;9170;91,08
3509403;Cajuru;2000;18382;2373;20755;88,57
3509452;Campina do Monte Alegre;2000;4169;1026;5195;80,25
3509502;Campinas;2000;952003;16157;968160;98,33
3509601;Campo Limpo Paulista;2000;62061;1459;63520;97,7
3509700;Campos do Jordão;2000;43736;442;44178;99
3509809;Campos Novos Paulista;2000;2987;1192;4179;71,48
3509908;Cananéia;2000;10178;2089;12267;82,97
3509957;Canas;2000;3033;572;3605;84,13
3510005;Cândido Mota;2000;26514;2727;29241;90,67
3510104;Cândido Rodrigues;2000;1944;666;2610;74,48
3510153;Canitar;2000;2669;800;3469;76,94
3510203;Capão Bonito;2000;36585;10144;46729;78,29
3510302;Capela do Alto;2000;11082;3128;14210;77,99
3510401;Capivari;2000;33423;7970;41393;80,75
3510500;Caraguatatuba;2000;74972;3656;78628;95,35
3510609;Carapicuíba;2000;343962;0;343962;100
3510708;Cardoso;2000;10361;1250;11611;89,23
3510807;Casa Branca;2000;21617;5168;26785;80,71
3510906;Cássia dos Coqueiros;2000;1664;1206;2870;57,98
3511003;Castilho;2000;11957;2988;14945;80,01
3511102;Catanduva;2000;104118;1577;105695;98,51
3511201;Catiguá;2000;5911;641;6552;90,22
3511300;Cedral;2000;4973;1717;6690;74,33
3511409;Cerqueira César;2000;13037;2084;15121;86,22
3511508;Cerquilho;2000;27895;1507;29402;94,87
3511607;Cesário Lange;2000;8909;3956;12865;69,25
3511706;Charqueada;2000;11698;1316;13014;89,89
3511904;Clementina;2000;4953;446;5399;91,74
3512001;Colina;2000;14878;1778;16656;89,33
3512100;Colômbia;2000;4115;1832;5947;69,19
3512209;Conchal;2000;20266;2375;22641;89,51
3512308;Conchas;2000;11254;3619;14873;75,67
3512407;Cordeirópolis;2000;16027;1519;17546;91,34
3512506;Coroados;2000;3304;1107;4411;74,9
3512605;Coronel Macedo;2000;4012;1579;5591;71,76
3512704;Corumbataí;2000;1715;2073;3788;45,27
3512803;Cosmópolis;2000;42445;1805;44250;95,92
3512902;Cosmorama;2000;4306;3070;7376;58,38
3513009;Cotia;2000;148519;0;148519;100
3513108;Cravinhos;2000;27123;1226;28349;95,68
3513207;Cristais Paulista;2000;3893;2677;6570;59,25
3513306;Cruzália;2000;1595;1016;2611;61,09
3513405;Cruzeiro;2000;71133;2311;73444;96,85
3513504;Cubatão;2000;107488;647;108135;99,4
3513603;Cunha;2000;11135;11958;23093;48,22
3513702;Descalvado;2000;24109;4780;28889;83,45
3513801;Diadema;2000;356535;0;356535;100
3513850;Dirce Reis;2000;1076;549;1625;66,22
3513900;Divinolândia;2000;6874;5140;12014;57,22
3514007;Dobrada;2000;6504;502;7006;92,83
3514106;Dois Córregos;2000;20198;2286;22484;89,83
3514205;Dolcinópolis;2000;1809;342;2151;84,1
3514304;Dourado;2000;7832;766;8598;91,09
3514403;Dracena;2000;37145;3346;40491;91,74
3514502;Duartina;2000;10779;1691;12470;86,44
3514601;Dumont;2000;5857;436;6293;93,07
3514700;Echaporã;2000;5182;1640;6822;75,96
3514809;Eldorado;2000;6969;7155;14124;49,34
3514908;Elias Fausto;2000;10252;3613;13865;73,94
3514924;Elisiário;2000;2190;387;2577;84,98
3514957;Embaúba;2000;1978;499;2477;79,85
3515004;Embu;2000;207103;0;207103;100
3515103;Embu-Guaçu;2000;55599;1072;56671;98,11
3515129;Emilianópolis;2000;2191;702;2893;75,73
3515152;Engenheiro Coelho;2000;6986;3014;10000;69,86
3515186;Espírito Santo do Pinhal;2000;34726;5722;40448;85,85
3515194;Espírito Santo do Turvo;2000;3235;435;3670;88,15
3515202;Estrela d'Oeste;2000;6385;1873;8258;77,32
3515301;Estrela do Norte;2000;1787;839;2626;68,05
3515350;Euclides da Cunha Paulista;2000;6427;3780;10207;62,97
3515400;Fartura;2000;11374;3630;15004;75,81
3515509;Fernandópolis;2000;59091;2502;61593;95,94
3515608;Fernando Prestes;2000;4111;1320;5431;75,7
3515657;Fernão;2000;678;756;1434;47,28
3515707;Ferraz de Vasconcelos;2000;140687;1165;141852;99,18
3515806;Flora Rica;2000;1569;610;2179;72,01
3515905;Floreal;2000;2471;755;3226;76,6
3516002;Flórida Paulista;2000;8992;2126;11118;80,88
3516101;Florínia;2000;2636;490;3126;84,33
3516200;Franca;2000;281639;5523;287162;98,08
3516309;Francisco Morato;2000;132981;162;133143;99,88
3516408;Franco da Rocha;2000;100173;7710;107883;92,85
3516507;Gabriel Monteiro;2000;2051;673;2724;75,29
3516606;Gália;2000;5595;2267;7862;71,17
3516705;Garça;2000;36372;6773;43145;84,3
3516804;Gastão Vidigal;2000;2938;650;3588;81,88
3516853;Gavião Peixoto;2000;2747;1376;4123;66,63
3516903;General Salgado;2000;8745;2074;10819;80,83
3517000;Getulina;2000;7533;2835;10368;72,66
3517109;Glicério;2000;3094;1332;4426;69,91
3517208;Guaiçara;2000;8042;1137;9179;87,61
3517307;Guaimbê;2000;4265;941;5206;81,92
3517406;Guaíra;2000;32240;2334;34574;93,25
3517505;Guapiaçu;2000;11851;2198;14049;84,35
3517604;Guapiara;2000;7534;12178;19712;38,22
3517703;Guará;2000;17934;956;18890;94,94
3517802;Guaraçai;2000;6678;2210;8888;75,14
3517901;Guaraci;2000;7383;1453;8836;83,56
3518008;Guarani d'Oeste;2000;1733;272;2005;86,43
3518107;Guarantã;2000;4842;1473;6315;76,67
3518206;Guararapes;2000;26111;2711;28822;90,59
3518305;Guararema;2000;17678;4186;21864;80,85
3518404;Guaratinguetá;2000;99050;5051;104101;95,15
3518503;Guareí;2000;6075;4104;10179;59,68
3518602;Guariba;2000;30200;861;31061;97,23
3518701;Guarujá;2000;264156;79;264235;99,97
3518800;Guarulhos;2000;1046627;22982;1069609;97,85
3518859;Guatapará;2000;4140;2225;6365;65,04
3518909;Guzolândia;2000;3369;932;4301;78,33
3519006;Herculândia;2000;6819;1164;7983;85,42
3519055;Holambra;2000;3929;3266;7195;54,61
3519071;Hortolândia;2000;151697;0;151697;100
3519105;Iacanga;2000;7068;1207;8275;85,41
3519204;Iacri;2000;4797;1989;6786;70,69
3519253;Iaras;2000;1889;1155;3044;62,06
3519303;Ibaté;2000;25032;1346;26378;94,9
3519402;Ibirá;2000;8297;1143;9440;87,89
3519501;Ibirarema;2000;5091;608;5699;89,33
3519600;Ibitinga;2000;43779;2755;46534;94,08
3519709;Ibiúna;2000;21302;42918;64220;33,17
3519808;Icém;2000;5742;1024;6766;84,87
3519907;Iepê;2000;5959;1299;7258;82,1
3520004;Igaraçu do Tietê;2000;22371;225;22596;99
3520103;Igarapava;2000;24003;1885;25888;92,72
3520202;Igaratá;2000;5862;2409;8271;70,87
3520301;Iguape;2000;21920;5490;27410;79,97
3520400;Ilhabela;2000;20506;246;20752;98,81
3520426;Ilha Comprida;2000;6653;0;6653;100
3520442;Ilha Solteira;2000;23199;777;23976;96,76
3520509;Indaiatuba;2000;144228;2302;146530;98,43
3520608;Indiana;2000;4059;870;4929;82,35
3520707;Indiaporã;2000;3193;871;4064;78,57
3520806;Inúbia Paulista;2000;2764;554;3318;83,3
3520905;Ipaussu;2000;11020;1522;12542;87,86
3521002;Iperó;2000;12584;5705;18289;68,81
3521101;Ipeúna;2000;3431;890;4321;79,4
3521150;Ipiguá;2000;1936;1525;3461;55,94
3521200;Iporanga;2000;2076;2487;4563;45,5
3521309;Ipuã;2000;11179;676;11855;94,3
3521408;Iracemápolis;2000;14774;743;15517;95,21
3521507;Irapuã;2000;5425;1228;6653;81,54
3521606;Irapuru;2000;5634;1830;7464;75,48
3521705;Itaberá;2000;11094;7807;18901;58,7
3521804;Itaí;2000;16876;4130;21006;80,34
3521903;Itajobi;2000;10860;3360;14220;76,37
3522000;Itaju;2000;1642;993;2635;62,31
3522109;Itanhaém;2000;70851;843;71694;98,82
3522158;Itaóca;2000;2178;1054;3232;67,39
3522208;Itapecerica da Serra;2000;127827;1353;129180;98,95
3522307;Itapetininga;2000;111918;13396;125314;89,31
3522406;Itapeva;2000;60886;21887;82773;73,56
3522505;Itapevi;2000;161810;0;161810;100
3522604;Itapira;2000;57980;5329;63309;91,58
3522653;Itapirapuã Paulista;2000;1651;1923;3574;46,19
3522703;Itápolis;2000;32100;5603;37703;85,14
3522802;Itaporanga;2000;9932;4423;14355;69,19
3522901;Itapuí;2000;9576;782;10358;92,45
3523008;Itapura;2000;3331;506;3837;86,81
3523107;Itaquaquecetuba;2000;271649;0;271649;100
3523206;Itararé;2000;42764;3744;46508;91,95
3523305;Itariri;2000;7434;6158;13592;54,69
3523404;Itatiba;2000;65754;15233;80987;81,19
3523503;Itatinga;2000;13518;1911;15429;87,61
3523602;Itirapina;2000;11151;1654;12805;87,08
3523701;Itirapuã;2000;4310;1099;5409;79,68
3523800;Itobi;2000;6198;1261;7459;83,09
3523909;Itu;2000;123670;11399;135069;91,56
3524006;Itupeva;2000;19192;6883;26075;73,6
3524105;Ituverava;2000;34191;2045;36236;94,36
3524204;Jaborandi;2000;5856;567;6423;91,17
3524303;Jaboticabal;2000;63761;3564;67325;94,71
3524402;Jacareí;2000;183109;7902;191011;95,86
3524501;Jaci;2000;2967;1141;4108;72,22
3524600;Jacupiranga;2000;10030;6989;17019;58,93
3524709;Jaguariúna;2000;25756;3777;29533;87,21
3524808;Jales;2000;42294;3843;46137;91,67
3524907;Jambeiro;2000;1931;2054;3985;48,46
3525003;Jandira;2000;91478;0;91478;100
3525102;Jardinópolis;2000;28003;2657;30660;91,33
3525201;Jarinu;2000;10938;6032;16970;64,45
3525300;Jaú;2000;107023;4898;111921;95,62
3525409;Jeriquara;2000;2510;770;3280;76,52
3525508;Joanópolis;2000;10386;0;10386;100
3525607;João Ramalho;2000;3069;765;3834;80,05
3525706;José Bonifácio;2000;24974;3688;28662;87,13
3525805;Júlio Mesquita;2000;3847;316;4163;92,41
3525854;Jumirim;2000;1090;1100;2190;49,77
3525904;Jundiaí;2000;299890;23166;323056;92,83
3526001;Junqueirópolis;2000;13426;3586;17012;78,92
3526100;Juquiá;2000;12418;8062;20480;60,63
3526209;Juquitiba;2000;17340;9048;26388;65,71
3526308;Lagoinha;2000;2875;2079;4954;58,03
3526407;Laranjal Paulista;2000;19555;2559;22114;88,43
3526506;Lavínia;2000;4136;998;5134;80,56
3526605;Lavrinhas;2000;5295;699;5994;88,34
3526704;Leme;2000;77764;2864;80628;96,45
3526803;Lençóis Paulista;2000;52249;2687;54936;95,11
3526902;Limeira;2000;237939;10679;248618;95,7
3527009;Lindóia;2000;4704;614;5318;88,45
3527108;Lins;2000;64154;1732;65886;97,37
3527207;Lorena;2000;75024;2890;77914;96,29
3527256;Lourdes;2000;1550;454;2004;77,35
3527306;Louveira;2000;21809;2008;23817;91,57
3527405;Lucélia;2000;15694;2617;18311;85,71
3527504;Lucianópolis;2000;1651;505;2156;76,58
3527603;Luís Antônio;2000;6545;601;7146;91,59
3527702;Luiziânia;2000;3704;569;4273;86,68
3527801;Lupércio;2000;2108;2120;4228;49,86
3527900;Lutécia;2000;2143;752;2895;74,02
3528007;Macatuba;2000;14971;758;15729;95,18
3528106;Macaubal;2000;6248;1137;7385;84,6
3528205;Macedônia;2000;2683;1080;3763;71,3
3528304;Magda;2000;2730;693;3423;79,75
3528403;Mairinque;2000;34241;5619;39860;85,9
3528502;Mairiporã;2000;47895;11988;59883;79,98
3528601;Manduri;2000;6363;1898;8261;77,02
3528700;Marabá Paulista;2000;2047;1650;3697;55,37
3528809;Maracaí;2000;11415;1583;12998;87,82
3528858;Marapoama;2000;1541;693;2234;68,98
3528908;Mariápolis;2000;2806;1052;3858;72,73
3529005;Marília;2000;189357;7608;196965;96,14
3529104;Marinópolis;2000;1646;548;2194;75,02
3529203;Martinópolis;2000;17954;4366;22320;80,44
3529302;Matão;2000;69087;2582;71669;96,4
3529401;Mauá;2000;362676;0;362676;100
3529500;Mendonça;2000;2762;994;3756;73,54
3529609;Meridiano;2000;2656;1367;4023;66,02
3529658;Mesópolis;2000;1218;713;1931;63,08
3529708;Miguelópolis;2000;17546;1457;19003;92,33
3529807;Mineiros do Tietê;2000;10943;447;11390;96,08
3529906;Miracatu;2000;10895;11454;22349;48,75
3530003;Mira Estrela;2000;1942;655;2597;74,78
3530102;Mirandópolis;2000;22274;3647;25921;85,93
3530201;Mirante do Paranapanema;2000;9827;6376;16203;60,65
3530300;Mirassol;2000;46484;1749;48233;96,37
3530409;Mirassolândia;2000;3118;616;3734;83,5
3530508;Mococa;2000;57222;8281;65503;87,36
3530607;Mogi das Cruzes;2000;301578;28075;329653;91,48
3530706;Mogi-Guaçu;2000;115956;8028;123984;93,52
3530805;Moji Mirim;2000;72943;8350;81293;89,73
3530904;Mombuca;2000;2267;835;3102;73,08
3531001;Monções;2000;1744;312;2056;84,82
3531100;Mongaguá;2000;34742;155;34897;99,56
3531209;Monte Alegre do Sul;2000;3277;3035;6312;51,92
3531308;Monte Alto;2000;40729;2845;43574;93,47
3531407;Monte Aprazível;2000;15929;2475;18404;86,55
3531506;Monte Azul Paulista;2000;17546;1988;19534;89,82
3531605;Monte Castelo;2000;3008;1087;4095;73,46
3531704;Monteiro Lobato;2000;1514;2099;3613;41,9
3531803;Monte Mor;2000;34051;3156;37207;91,52
3531902;Morro Agudo;2000;22764;2622;25386;89,67
3532009;Morungaba;2000;7772;2121;9893;78,56
3532058;Motuca;2000;2443;1423;3866;63,19
3532108;Murutinga do Sul;2000;2593;1376;3969;65,33
3532157;Nantes;2000;1661;611;2272;73,11
3532207;Narandiba;2000;2278;1459;3737;60,96
3532306;Natividade da Serra;2000;2851;4096;6947;41,04
3532405;Nazaré Paulista;2000;5818;8563;14381;40,46
3532504;Neves Paulista;2000;7739;1162;8901;86,95
3532603;Nhandeara;2000;7881;2315;10196;77,3
3532702;Nipoã;2000;2801;461;3262;85,87
3532801;Nova Aliança;2000;3614;1148;4762;75,89
3532827;Nova Campina;2000;3866;3406;7272;53,16
3532843;Nova Canaã Paulista;2000;823;1662;2485;33,12
3532868;Nova Castilho;2000;486;504;990;49,09
3532900;Nova Europa;2000;6456;830;7286;88,61
3533007;Nova Granada;2000;15020;1978;16998;88,36
3533106;Nova Guataporanga;2000;1728;359;2087;82,8
3533205;Nova Independência;2000;1503;559;2062;72,89
3533254;Novais;2000;2668;556;3224;82,75
3533304;Nova Lusitânia;2000;2287;461;2748;83,22
3533403;Nova Odessa;2000;41028;959;41987;97,72
3533502;Novo Horizonte;2000;28900;3513;32413;89,16
3533601;Nuporanga;2000;5069;1235;6304;80,41
3533700;Ocauçu;2000;2915;1250;4165;69,99
3533809;Óleo;2000;1772;1220;2992;59,22
3533908;Olímpia;2000;42613;3368;45981;92,68
3534005;Onda Verde;2000;2315;1092;3407;67,95
3534104;Oriente;2000;5069;823;5892;86,03
3534203;Orindiúva;2000;3672;477;4149;88,5
3534302;Orlândia;2000;35161;795;35956;97,79
3534401;Osasco;2000;651736;0;651736;100
3534500;Oscar Bressane;2000;1927;625;2552;75,51
3534609;Osvaldo Cruz;2000;26135;3506;29641;88,17
3534708;Ourinhos;2000;89209;4484;93693;95,21
3534757;Ouroeste;2000;4651;1625;6276;74,11
3534807;Ouro Verde;2000;6344;803;7147;88,76
3534906;Pacaembu;2000;9496;3021;12517;75,86
3535002;Palestina;2000;7227;1872;9099;79,43
3535101;Palmares Paulista;2000;8094;331;8425;96,07
3535200;Palmeira d'Oeste;2000;7088;3239;10327;68,64
3535309;Palmital;2000;16776;3905;20681;81,12
3535408;Panorama;2000;12653;983;13636;92,79
3535507;Paraguaçu Paulista;2000;36570;2989;39559;92,44
3535606;Paraibuna;2000;5288;11700;16988;31,13
3535705;Paraíso;2000;4451;971;5422;82,09
3535804;Paranapanema;2000;11647;3835;15482;75,23
3535903;Paranapuã;2000;3030;603;3633;83,4
3536000;Parapuã;2000;8496;2611;11107;76,49
3536109;Pardinho;2000;2983;1735;4718;63,23
3536208;Pariquera-Açu;2000;11690;5911;17601;66,42
3536257;Parisi;2000;1504;440;1944;77,37
3536307;Patrocínio Paulista;2000;8593;2806;11399;75,38
3536406;Paulicéia;2000;3925;1365;5290;74,2
3536505;Paulínia;2000;50601;562;51163;98,9
3536570;Paulistânia;2000;998;780;1778;56,13
3536604;Paulo de Faria;2000;7441;1029;8470;87,85
3536703;Pederneiras;2000;34048;2519;36567;93,11
3536802;Pedra Bela;2000;1204;4400;5604;21,48
3536901;Pedranópolis;2000;1654;1083;2737;60,43
3537008;Pedregulho;2000;10900;4082;14982;72,75
3537107;Pedreira;2000;34056;1085;35141;96,91
3537156;Pedrinhas Paulista;2000;2312;546;2858;80,9
3537206;Pedro de Toledo;2000;6150;3023;9173;67,04
3537305;Penápolis;2000;50560;4010;54570;92,65
3537404;Pereira Barreto;2000;23147;1886;25033;92,47
3537503;Pereiras;2000;4153;2054;6207;66,91
3537602;Peruíbe;2000;50160;1077;51237;97,9
3537701;Piacatu;2000;3806;818;4624;82,31
3537800;Piedade;2000;22028;28037;50065;44
3537909;Pilar Do Sul;2000;17438;6464;23902;72,96
3538006;Pindamonhangaba;2000;118841;6934;125775;94,49
3538105;Pindorama;2000;12078;1023;13101;92,19
3538204;Pinhalzinho;2000;5278;5681;10959;48,16
3538303;Piquerobi;2000;2453;1023;3476;70,57
3538501;Piquete;2000;14205;991;15196;93,48
3538600;Piracaia;2000;23303;0;23303;100
3538709;Piracicaba;2000;316876;11766;328642;96,42
3538808;Piraju;2000;24280;3599;27879;87,09
3538907;Pirajuí;2000;16257;3826;20083;80,95
3539004;Pirangi;2000;8685;1351;10036;86,54
3539103;Pirapora do Bom Jesus;2000;12337;7;12344;99,94
3539202;Pirapozinho;2000;20705;1388;22093;93,72
3539301;Pirassununga;2000;57521;7261;64782;88,79
3539400;Piratininga;2000;8849;1726;10575;83,68
3539509;Pitangueiras;2000;29265;1847;31112;94,06
3539608;Planalto;2000;2827;841;3668;77,07
3539707;Platina;2000;2119;748;2867;73,91
3539806;Poá;2000;94470;1127;95597;98,82
3539905;Poloni;2000;4261;510;4771;89,31
3540002;Pompéia;2000;16714;1448;18162;92,03
3540101;Pongaí;2000;2908;784;3692;78,76
3540200;Pontal;2000;28515;1093;29608;96,31
3540259;Pontalinda;2000;2680;856;3536;75,79
3540309;Pontes Gestal;2000;1938;605;2543;76,21
3540408;Populina;2000;3427;1025;4452;76,98
3540507;Porangaba;2000;3466;3176;6642;52,18
3540606;Porto Feliz;2000;36532;8892;45424;80,42
3540705;Porto Ferreira;2000;45478;1865;47343;96,06
3540754;Potim;2000;12926;636;13562;95,31
3540804;Potirendaba;2000;11663;1968;13631;85,56
3540853;Pracinha;2000;1187;245;1432;82,89
3540903;Pradópolis;2000;11846;1034;12880;91,97
3541000;Praia Grande;2000;192769;0;192769;100
3541059;Pratânia;2000;2714;1227;3941;68,87
3541109;Presidente Alves;2000;3317;1002;4319;76,8
3541208;Presidente Bernardes;2000;10146;4504;14650;69,26
3541307;Presidente Epitácio;2000;36314;2940;39254;92,51
3541406;Presidente Prudente;2000;184997;3952;188949;97,91
3541505;Presidente Venceslau;2000;34543;2792;37335;92,52
3541604;Promissão;2000;25609;5464;31073;82,42
3541653;Quadra;2000;668;1975;2643;25,27
3541703;Quatá;2000;10545;1107;11652;90,5
3541802;Queiroz;2000;1657;512;2169;76,39
3541901;Queluz;2000;7834;1264;9098;86,11
3542008;Quitana;2000;4912;528;5440;90,29
3542107;Rafard;2000;7171;1191;8362;85,76
3542206;Rancharia;2000;24973;3781;28754;86,85
3542305;Redenção da Serra;2000;1627;2420;4047;40,2
3542404;Regente Feijó;2000;15247;1730;16977;89,81
3542503;Reginópolis;2000;3784;958;4742;79,8
3542602;Registro;2000;43028;10676;53704;80,12
3542701;Restinga;2000;4133;1439;5572;74,17
3542800;Ribeira;2000;1007;2505;3512;28,67
3542909;Ribeirão Bonito;2000;9951;1286;11237;88,56
3543006;Ribeirão Branco;2000;8977;12234;21211;42,32
3543105;Ribeirão Corrente;2000;2934;940;3874;75,74
3543204;Ribeirão do Sul;2000;2853;1635;4488;63,57
3543238;Ribeirão dos Índios;2000;1759;462;2221;79,2
3543253;Ribeirão Grande;2000;2321;5056;7377;31,46
3543303;Ribeirão Pires;2000;104305;0;104305;100
3543402;Ribeirão Preto;2000;502002;2160;504162;99,57
3543501;Riversul;2000;5055;2155;7210;70,11
3543600;Rifaina;2000;2863;458;3321;86,21
3543709;Rincão;2000;8257;2073;10330;79,93
3543808;Rinópolis;2000;7954;2309;10263;77,5
3543907;Rio Claro;2000;163170;4732;167902;97,18
3544004;Rio das Pedras;2000;21911;1537;23448;93,45
3544103;Rio Grande da Serra;2000;37015;0;37015;100
3544202;Riolândia;2000;6854;1698;8552;80,14
3544251;Rosana;2000;6189;18003;24192;25,58
3544301;Roseira;2000;7989;562;8551;93,43
3544400;Rubiácea;2000;1270;1070;2340;54,27
3544509;Rubinéia;2000;1913;698;2611;73,27
3544608;Sabino;2000;4087;860;4947;82,62
3544707;Sagres;2000;1579;862;2441;64,69
3544806;Sales;2000;3553;1002;4555;78
3544905;Sales Oliveira;2000;7827;1481;9308;84,09
3545001;Salesópolis;2000;8722;5604;14326;60,88
3545100;Salmourão;2000;3562;840;4402;80,92
3545159;Saltinho;2000;4807;985;5792;82,99
3545209;Salto;2000;91842;1091;92933;98,83
3545308;Salto de Pirapora;2000;27300;7665;34965;78,08
3545407;Salto Grande;2000;7381;1056;8437;87,48
3545506;Sandovalina;2000;1746;1336;3082;56,65
3545605;Santa Adélia;2000;12063;1378;13441;89,75
3545704;Santa Albertina;2000;4435;1154;5589;79,35
3545803;Santa Bárbara d'Oeste;2000;167660;2158;169818;98,73
3546009;Santa Branca;2000;11696;1286;12982;90,09
3546108;Santa Clara d'Oeste;2000;1466;660;2126;68,96
3546207;Santa Cruz da Conceição;2000;1931;1594;3525;54,78
3546256;Santa Cruz da Esperança;2000;1196;599;1795;66,63
3546306;Santa Cruz das Palmeiras;2000;23992;1525;25517;94,02
3546405;Santa Cruz do Rio Pardo;2000;35083;5793;40876;85,83
3546504;Santa Ernestina;2000;4390;1349;5739;76,49
3546603;Santa Fé do Sul;2000;24879;1599;26478;93,96
3546702;Santa Gertrudes;2000;15468;377;15845;97,62
3546801;Santa Isabel;2000;32970;10712;43682;75,48
3546900;Santa Lucia;2000;7031;806;7837;89,72
3547007;Santa Maria da Serra;2000;3947;722;4669;84,54
3547106;Santa Mercedes;2000;2233;572;2805;79,61
3547205;Santana da Ponte Pensa;2000;1108;790;1898;58,38
3547304;Santana de Parnaíba;2000;74343;0;74343;100
3547403;Santa Rita d'Oeste;2000;1557;1144;2701;57,65
3547502;Santa Rita do Passa Quatro;2000;22476;3642;26118;86,06
3547601;Santa Rosa do Viterbo;2000;20175;1238;21413;94,22
3547650;Santa Salete;2000;541;838;1379;39,23
3547700;Santo Anastácio;2000;19037;1704;20741;91,78
3547809;Santo André;2000;649000;0;649000;100
3547908;Santo Antonio da Alegria;2000;4189;1568;5757;72,76
3548005;Santo Antonio da Posse;2000;14633;3441;18074;80,96
3548054;Santo Antonio do Aracanguá;2000;4537;2393;6930;65,47
3548104;Santo Antonio do Jardim;2000;3272;2878;6150;53,2
3548203;Santo Antonio do Pinhal;2000;3026;3292;6318;47,89
3548302;Santo Expedito;2000;1999;524;2523;79,23
3548401;Santópolis do Aguapeí;2000;3587;229;3816;94
3548500;Santos;2000;415739;2236;417975;99,47
3548609;São Bento do Sapucaí;2000;4620;5719;10339;44,69
3548708;São Bernardo do Campo;2000;689521;12235;701756;98,26
3548807;São Caetano do Sul;2000;140241;0;140241;100
3548906;São Carlos;2000;183092;9547;192639;95,04
3549003;São Francisco;2000;2053;807;2860;71,78
3549102;São João da Boa Vista;2000;71674;5630;77304;92,72
3549201;São João das Duas Pontes;2000;2016;645;2661;75,76
3549250;São João de Iracema;2000;1158;513;1671;69,3
3549300;São João do Pau d'Alho;2000;1615;570;2185;73,91
3549409;São Joaquim da Barra;2000;40743;787;41530;98,1
3549508;São José da Bela Vista;2000;6959;1107;8066;86,28
3549607;São José do Barreiro;2000;2470;1671;4141;59,65
3549706;São José do Rio Pardo;2000;41590;8432;50022;83,14
3549805;São José do Rio Preto;2000;336519;21186;357705;94,08
3549904;São José dos Campos;2000;531714;6584;538298;98,78
3549953;São Lourenço da Serra;2000;10733;1412;12145;88,37
3550001;São Luís do Paraitinga;2000;6142;4282;10424;58,92
3550100;São Manuel;2000;34003;2499;36502;93,15
3550209;São Miguel Arcanjo;2000;17953;12790;30743;58,4
3550308;São Paulo;2000;9805787;620597;10426384;94,05
3550407;São Pedro;2000;22364;5447;27811;80,41
3550506;São Pedro do Turvo;2000;4400;2489;6889;63,87
3550605;São Roque;2000;48654;17883;66537;73,12
3550704;São Sebastião;2000;57162;583;57745;98,99
3550803;São Sebastião da Grama;2000;7490;4958;12448;60,17
3550902;São Simão;2000;11925;1733;13658;87,31
3551009;São Vicente;2000;303061;138;303199;99,95
3551108;Sarapuí;2000;5095;2697;7792;65,39
3551207;Sarutaiá;2000;2822;910;3732;75,62
3551306;Sebastianópolis do Sul;2000;1649;897;2546;64,77
3551405;Serra Azul;2000;6796;637;7433;91,43
3551504;Serrana;2000;31718;781;32499;97,6
3551603;Serra Negra;2000;20593;3236;23829;86,42
3551702;Sertãozinho;2000;90373;4126;94499;95,63
3551801;Sete Barras;2000;4640;9062;13702;33,86
3551900;Severínia;2000;12130;1440;13570;89,39
3552007;Silveiras;2000;2449;2924;5373;45,58
3552106;Socorro;2000;20967;11717;32684;64,15
3552205;Sorocaba;2000;485520;6725;492245;98,63
3552304;Sud Mennucci;2000;6311;1052;7363;85,71
3552403;Sumaré;2000;193322;2777;196099;98,58
3552502;Suzano;2000;220675;7242;227917;96,82
3552551;Suzanópolis;2000;1936;850;2786;69,49
3552601;Tabapuã;2000;9013;1475;10488;85,94
3552700;Tabatinga;2000;10165;2802;12967;78,39
3552809;Taboão da Serra;2000;197247;0;197247;100
3552908;Taciba;2000;4238;978;5216;81,25
3553005;Taguaí;2000;6400;1058;7458;85,81
3553104;Taiaçu;2000;4842;771;5613;86,26
3553203;Taiúva;2000;4755;748;5503;86,41
3553302;Tambaú;2000;19023;3211;22234;85,56
3553401;Tanabi;2000;17981;4596;22577;79,64
3553500;Tapiraí;2000;5765;2773;8538;67,52
3553609;Tapiratiba;2000;9213;3718;12931;71,25
3553658;Taquaral;2000;2580;141;2721;94,82
3553708;Taquaritinga;2000;47544;4469;52013;91,41
3553807;Taquarituba;2000;18299;3648;21947;83,38
3553856;Taquarivaí;2000;2274;2183;4457;51,02
3553906;Tarabaí;2000;5217;558;5775;90,34
3553955;Tarumã;2000;9635;1096;10731;89,79
3554003;Tatuí;2000;85434;7801;93235;91,63
3554102;Taubaté;2000;229495;14288;243783;94,14
3554201;Tejupá;2000;2720;2610;5330;51,03
3554300;Teodoro Sampaio;2000;15912;4079;19991;79,6
3554409;Terra Roxa;2000;7217;524;7741;93,23
3554508;Tietê;2000;28613;3025;31638;90,44
3554607;Timburi;2000;1813;919;2732;66,36
3554656;Torre de Pedra;2000;1251;882;2133;58,65
3554706;Torrinha;2000;7278;1546;8824;82,48
3554755;Trabiju;2000;1230;150;1380;89,13
3554805;Tremembé;2000;29800;4946;34746;85,77
3554904;Três Fronteiras;2000;4066;1092;5158;78,83
3554953;Tuiuti;2000;2267;2680;4947;45,83
3555000;Tupã;2000;60323;2965;63288;95,32
3555109;Tupi Paulista;2000;10883;2410;13293;81,87
3555208;Turiúba;2000;1493;404;1897;78,7
3555307;Turmalina;2000;1549;820;2369;65,39
3555356;Ubarana;2000;3797;407;4204;90,32
3555406;Ubatuba;2000;64983;1661;66644;97,51
3555505;Ubirajara;2000;2997;1159;4156;72,11
3555604;Uchôa;2000;7876;1152;9028;87,24
3555703;União Paulista;2000;973;381;1354;71,86
3555802;Urânia;2000;7063;1759;8822;80,06
3555901;Uru;2000;989;415;1404;70,44
3556008;Urupês;2000;9780;2045;11825;82,71
3556107;Valentim Gentil;2000;7501;1074;8575;87,48
3556206;Valinhos;2000;78358;4459;82817;94,62
3556305;Valparaíso;2000;16070;2484;18554;86,61
3556354;Vargem;2000;2602;4351;6953;37,42
3556404;Vargem Grande do Sul;2000;33661;2586;36247;92,87
3556453;Vargem Grande Paulista;2000;32464;0;32464;100
3556503;Várzea Paulista;2000;92537;0;92537;100
3556602;Vera Cruz;2000;9164;1921;11085;82,67
3556701;Vinhedo;2000;46027;1038;47065;97,79
3556800;Viradouro;2000;15059;874;15933;94,51
3556909;Vista Alegre do Alto;2000;4133;609;4742;87,16
3556958;Vitória Brasil;2000;1188;485;1673;71,01
3557006;Votorantim;2000;92570;3197;95767;96,66
3557105;Votuporanga;2000;72698;2830;75528;96,25
3557154;Zacarias;2000;1332;615;1947;68,41
3557204;Chavantes;2000;10436;1753;12189;85,62
3557303;Estiva Gerbi;2000;7621;1211;8832;86,29
3500105;Adamantina;2005;31120;2644;33764;92,17
3500204;Adolfo;2005;3127;517;3644;85,81
3500303;Aguaí;2005;26703;3481;30184;88,47
3500402;Águas da Prata;2005;6387;943;7330;87,14
3500501;Águas de Lindóia;2005;16239;459;16698;97,25
3500550;Águas de Santa Bárbara;2005;4053;1375;5428;74,67
3500600;Águas de São Pedro;2005;2287;0;2287;100
3500709;Agudos;2005;31792;1788;33580;94,68
3500758;Alambari;2005;2975;1281;4256;69,9
3500808;Alfredo Marcondes;2005;2941;870;3811;77,17
3500907;Altair;2005;2773;883;3656;75,85
3501004;Altinópolis;2005;13063;2609;15672;83,35
3501103;Alto Alegre;2005;3123;1064;4187;74,59
3501152;Alumínio;2005;13903;2237;16140;86,14
3501202;Álvares Florence;2005;2652;1473;4125;64,29
3501301;Álvares Machado;2005;20609;2652;23261;88,6
3501400;Álvaro de Carvalho;2005;2679;1696;4375;61,23
3501509;Alvinlândia;2005;2555;363;2918;87,56
3501608;Americana;2005;196188;650;196838;99,67
3501707;Américo Brasiliense;2005;30674;577;31251;98,15
3501806;Américo de Campos;2005;4580;1082;5662;80,89
3501905;Amparo;2005;47364;15904;63268;74,86
3502002;Analândia;2005;2996;927;3923;76,37
3502101;Andradina;2005;51226;4207;55433;92,41
3502200;Angatuba;2005;14508;6320;20828;69,66
3502309;Anhembi;2005;3724;1331;5055;73,67
3502408;Anhumas;2005;2761;815;3576;77,21
3502507;Aparecida;2005;34396;476;34872;98,64
3502606;Aparecida d'Oeste;2005;3652;1068;4720;77,37
3502705;Apiaí;2005;17408;9039;26447;65,82
3502754;Araçariguama;2005;11051;2966;14017;78,84
3502804;Araçatuba;2005;170982;4847;175829;97,24
3502903;Araçoiaba da Serra;2005;15968;7535;23503;67,94
3503000;Aramina;2005;4461;483;4944;90,23
3503109;Arandu;2005;4301;1874;6175;69,65
3503158;Arapeí;2005;1882;668;2550;73,8
3503208;Araraquara;2005;187106;8222;195328;95,79
3503307;Araras;2005;104746;6559;111305;94,11
3503356;Arco-Íris;2005;1082;973;2055;52,65
3503406;Arealva;2005;5681;1885;7566;75,09
3503505;Areias;2005;2459;1209;3668;67,04
3503604;Areiópolis;2005;8966;1535;10501;85,38
3503703;Ariranha;2005;7448;563;8011;92,97
3503802;Artur Nogueira;2005;34660;3973;38633;89,72
3503901;Arujá;2005;63545;3465;67010;94,83
3503950;Aspásia;2005;1215;628;1843;65,93
3504008;Assis;2005;86959;4225;91184;95,37
3504107;Atibaia;2005;105384;13958;119342;88,3
3504206;Auriflama;2005;12388;1547;13935;88,9
3504305;Avaí;2005;3259;1518;4777;68,22
3504404;Avanhandava;2005;8783;1262;10045;87,44
3504503;Avaré;2005;75657;4051;79708;94,92
3504602;Bady Bassitt;2005;11776;1281;13057;90,19
3504701;Balbinos;2005;1119;1387;2506;44,65
3504800;Bálsamo;2005;6857;886;7743;88,56
3504909;Bananal;2005;7648;2359;10007;76,43
3505005;Barão de Antonina;2005;1774;1186;2960;59,93
3505104;Barbosa;2005;5208;1025;6233;83,56
3505203;Bariri;2005;27904;2061;29965;93,12
3505302;Barra Bonita;2005;34638;842;35480;97,63
3505351;Barra do Chapéu;2005;1494;3581;5075;29,44
3505401;Barra do Turvo;2005;3018;4959;7977;37,83
3505500;Barretos;2005;103554;4365;107919;95,96
3505609;Barrinha;2005;25926;361;26287;98,63
3505708;Barueri;2005;224616;0;224616;100
3505807;Bastos;2005;17315;3343;20658;83,82
3505906;Batatais;2005;49041;4816;53857;91,06
3506003;Bauru;2005;325064;5686;330750;98,28
3506102;Bebedouro;2005;70681;4530;75211;93,98
3506201;Bento de Abreu;2005;2186;325;2511;87,06
3506300;Bernardino de Campos;2005;9477;1313;10790;87,83
3506359;Bertioga;2005;37688;812;38500;97,89
3506409;Bilac;2005;5891;716;6607;89,16
3506508;Birigui;2005;97825;3633;101458;96,42
3506607;Biritiba Mirim;2005;22475;4155;26630;84,4
3506706;Boa Esperança do Sul;2005;11426;1722;13148;86,9
3506805;Bocaina;2005;9199;926;10125;90,85
3506904;Bofete;2005;5647;2833;8480;66,59
3507001;Boituva;2005;38203;2887;41090;92,97
3507100;Bom Jesus dos Perdões;2005;13870;2583;16453;84,3
3507159;Bom Sucesso de Itararé;2005;2161;1234;3395;63,65
3507209;Borá;2005;626;177;803;77,96
3507308;Boracéia;2005;3527;461;3988;88,44
3507407;Borborema;2005;11893;2023;13916;85,46
3507456;Borebi;2005;1715;400;2115;81,09
3507506;Botucatu;2005;112658;5117;117775;95,66
3507605;Bragança Paulista;2005;125431;10649;136080;92,17
3507704;Braúna;2005;3863;822;4685;82,45
3507753;Brejo Alegre;2005;1936;518;2454;78,89
3507803;Brodowski;2005;18274;917;19191;95,22
3507902;Brotas;2005;17274;2973;20247;85,32
3508009;Buri;2005;14289;3862;18151;78,72
3508108;Buritama;2005;13526;1104;14630;92,45
3508207;Buritizal;2005;3091;769;3860;80,08
3508306;Cabrália Paulista;2005;3879;668;4547;85,31
3508405;Cabreúva;2005;30012;7263;37275;80,52
3508504;Caçapava;2005;69326;11164;80490;86,13
3508603;Cachoeira Paulista;2005;23050;5624;28674;80,39
3508702;Caconde;2005;12209;6422;18631;65,53
3508801;Cafelândia;2005;13702;2533;16235;84,4
3508900;Caiabu;2005;3209;896;4105;78,17
3509007;Caieiras;2005;75559;3164;78723;95,98
3509106;Caiuá;2005;1845;2764;4609;40,03
3509205;Cajamar;2005;55503;1849;57352;96,78
3509254;Cajati;2005;20791;8229;29020;71,64
3509304;Cajobi;2005;8725;800;9525;91,6
3509403;Cajuru;2005;19533;2550;22083;88,45
3509452;Campina do Monte Alegre;2005;4416;999;5415;81,55
3509502;Campinas;2005;1004052;20155;1024207;98,03
3509601;Campo Limpo Paulista;2005;67753;1082;68835;98,43
3509700;Campos do Jordão;2005;46001;363;46364;99,22
3509809;Campos Novos Paulista;2005;3243;1105;4348;74,59
3509908;Cananéia;2005;10246;2024;12270;83,5
3509957;Canas;2005;3504;469;3973;88,2
3510005;Cândido Mota;2005;27285;2361;29646;92,04
3510104;Cândido Rodrigues;2005;2044;608;2652;77,07
3510153;Canitar;2005;3313;666;3979;83,26
3510203;Capão Bonito;2005;37182;9871;47053;79,02
3510302;Capela do Alto;2005;12525;3396;15921;78,67
3510401;Capivari;2005;39134;5920;45054;86,86
3510500;Caraguatatuba;2005;85020;4763;89783;94,69
3510609;Carapicuíba;2005;357275;0;357275;100
3510708;Cardoso;2005;10533;1235;11768;89,51
3510807;Casa Branca;2005;22357;5205;27562;81,12
3510906;Cássia dos Coqueiros;2005;1726;1069;2795;61,75
3511003;Castilho;2005;12732;3704;16436;77,46
3511102;Catanduva;2005;107871;1497;109368;98,63
3511201;Catiguá;2005;6228;615;6843;91,01
3511300;Cedral;2005;5586;1745;7331;76,2
3511409;Cerqueira César;2005;14298;2122;16420;87,08
3511508;Cerquilho;2005;32323;2090;34413;93,93
3511607;Cesário Lange;2005;9638;4519;14157;68,08
3511706;Charqueada;2005;12642;1404;14046;90
3511904;Clementina;2005;5764;424;6188;93,15
3512001;Colina;2005;15530;1538;17068;90,99
3512100;Colômbia;2005;4221;1743;5964;70,77
3512209;Conchal;2005;21938;2103;24041;91,25
3512308;Conchas;2005;12177;3390;15567;78,22
3512407;Cordeirópolis;2005;17390;1897;19287;90,16
3512506;Coroados;2005;3738;1083;4821;77,54
3512605;Coronel Macedo;2005;3936;1366;5302;74,24
3512704;Corumbataí;2005;1894;1939;3833;49,41
3512803;Cosmópolis;2005;48072;3409;51481;93,38
3512902;Cosmorama;2005;4610;2709;7319;62,99
3513009;Cotia;2005;175036;0;175036;100
3513108;Cravinhos;2005;28921;1191;30112;96,04
3513207;Cristais Paulista;2005;4620;2470;7090;65,16
3513306;Cruzália;2005;1554;914;2468;62,97
3513405;Cruzeiro;2005;73051;2330;75381;96,91
3513504;Cubatão;2005;113413;456;113869;99,6
3513603;Cunha;2005;11618;11066;22684;51,22
3513702;Descalvado;2005;25861;4169;30030;86,12
3513801;Diadema;2005;372856;0;372856;100
3513850;Dirce Reis;2005;1171;481;1652;70,88
3513900;Divinolândia;2005;7176;4531;11707;61,3
3514007;Dobrada;2005;7095;352;7447;95,27
3514106;Dois Córregos;2005;21654;1885;23539;91,99
3514205;Dolcinópolis;2005;1877;252;2129;88,16
3514304;Dourado;2005;7847;780;8627;90,96
3514403;Dracena;2005;38489;3485;41974;91,7
3514502;Duartina;2005;10878;1555;12433;87,49
3514601;Dumont;2005;6773;454;7227;93,72
3514700;Echaporã;2005;5098;1514;6612;77,1
3514809;Eldorado;2005;6955;7530;14485;48,02
3514908;Elias Fausto;2005;11324;3535;14859;76,21
3514924;Elisiário;2005;2498;345;2843;87,86
3514957;Embaúba;2005;2016;447;2463;81,85
3515004;Embu;2005;223753;0;223753;100
3515103;Embu-Guaçu;2005;58149;1753;59902;97,07
3515129;Emilianópolis;2005;2339;634;2973;78,67
3515152;Engenheiro Coelho;2005;8902;3874;12776;69,68
3515186;Espírito Santo do Pinhal;2005;35904;5499;41403;86,72
3515194;Espírito Santo do Turvo;2005;3422;536;3958;86,46
3515202;Estrela d'Oeste;2005;6599;1675;8274;79,76
3515301;Estrela do Norte;2005;1936;695;2631;73,58
3515350;Euclides da Cunha Paulista;2005;6270;3687;9957;62,97
3515400;Fartura;2005;11789;3359;15148;77,83
3515509;Fernandópolis;2005;60841;2594;63435;95,91
3515608;Fernando Prestes;2005;4389;1095;5484;80,03
3515657;Fernão;2005;757;755;1512;50,07
3515707;Ferraz de Vasconcelos;2005;150051;5516;155567;96,45
3515806;Flora Rica;2005;1492;480;1972;75,66
3515905;Floreal;2005;2454;685;3139;78,18
3516002;Flórida Paulista;2005;9525;2442;11967;79,59
3516101;Florínia;2005;2575;424;2999;85,86
3516200;Franca;2005;296622;7259;303881;97,61
3516309;Francisco Morato;2005;143954;226;144180;99,84
3516408;Franco da Rocha;2005;110033;9932;119965;91,72
3516507;Gabriel Monteiro;2005;2148;565;2713;79,17
3516606;Gália;2005;5400;2064;7464;72,35
3516705;Garça;2005;37746;5555;43301;87,17
3516804;Gastão Vidigal;2005;3316;547;3863;85,84
3516853;Gavião Peixoto;2005;3124;1161;4285;72,91
3516903;General Salgado;2005;8888;1865;10753;82,66
3517000;Getulina;2005;7923;2671;10594;74,79
3517109;Glicério;2005;3224;1272;4496;71,71
3517208;Guaiçara;2005;8817;1091;9908;88,99
3517307;Guaimbê;2005;4492;863;5355;83,88
3517406;Guaíra;2005;34069;2012;36081;94,42
3517505;Guapiaçu;2005;13652;2233;15885;85,94
3517604;Guapiara;2005;7378;11734;19112;38,6
3517703;Guará;2005;18565;847;19412;95,64
3517802;Guaraçai;2005;6663;2051;8714;76,46
3517901;Guaraci;2005;8094;1261;9355;86,52
3518008;Guarani d'Oeste;2005;1733;250;1983;87,39
3518107;Guarantã;2005;5126;1258;6384;80,29
3518206;Guararapes;2005;27168;2587;29755;91,31
3518305;Guararema;2005;19801;4185;23986;82,55
3518404;Guaratinguetá;2005;102683;5827;108510;94,63
3518503;Guareí;2005;7130;5229;12359;57,69
3518602;Guariba;2005;32358;884;33242;97,34
3518701;Guarujá;2005;278098;68;278166;99,98
3518800;Guarulhos;2005;1129601;18950;1148551;98,35
3518859;Guatapará;2005;4599;2077;6676;68,89
3518909;Guzolândia;2005;3676;863;4539;80,99
3519006;Herculândia;2005;7343;1023;8366;87,77
3519055;Holambra;2005;5680;3572;9252;61,39
3519071;Hortolândia;2005;172472;0;172472;100
3519105;Iacanga;2005;7847;1278;9125;85,99
3519204;Iacri;2005;4914;1681;6595;74,51
3519253;Iaras;2005;2307;2364;4671;49,39
3519303;Ibaté;2005;27147;1385;28532;95,15
3519402;Ibirá;2005;9118;1017;10135;89,97
3519501;Ibirarema;2005;5615;583;6198;90,59
3519600;Ibitinga;2005;47231;2560;49791;94,86
3519709;Ibiúna;2005;22951;45287;68238;33,63
3519808;Icém;2005;6062;1052;7114;85,21
3519907;Iepê;2005;6352;1102;7454;85,22
3520004;Igaraçu do Tietê;2005;22789;258;23047;98,88
3520103;Igarapava;2005;25137;1800;26937;93,32
3520202;Igaratá;2005;6402;2219;8621;74,26
3520301;Iguape;2005;23227;5167;28394;81,8
3520400;Ilhabela;2005;24195;219;24414;99,1
3520426;Ilha Comprida;2005;7811;0;7811;100
3520442;Ilha Solteira;2005;23342;1266;24608;94,86
3520509;Indaiatuba;2005;171626;2202;173828;98,73
3520608;Indiana;2005;4092;811;4903;83,46
3520707;Indiaporã;2005;3285;712;3997;82,19
3520806;Inúbia Paulista;2005;2960;511;3471;85,28
3520905;Ipaussu;2005;11769;1368;13137;89,59
3521002;Iperó;2005;15273;7916;23189;65,86
3521101;Ipeúna;2005;4194;969;5163;81,23
3521150;Ipiguá;2005;2281;1685;3966;57,51
3521200;Iporanga;2005;2231;2220;4451;50,12
3521309;Ipuã;2005;12298;752;13050;94,24
3521408;Iracemápolis;2005;16983;695;17678;96,07
3521507;Irapuã;2005;5929;1028;6957;85,22
3521606;Irapuru;2005;5568;2097;7665;72,64
3521705;Itaberá;2005;11571;6932;18503;62,54
3521804;Itaí;2005;17816;4742;22558;78,98
3521903;Itajobi;2005;11467;2960;14427;79,48
3522000;Itaju;2005;1964;984;2948;66,62
3522109;Itanhaém;2005;78834;834;79668;98,95
3522158;Itaóca;2005;1948;1321;3269;59,59
3522208;Itapecerica da Serra;2005;138705;3435;142140;97,58
3522307;Itapetininga;2005;120821;14601;135422;89,22
3522406;Itapeva;2005;67071;18982;86053;77,94
3522505;Itapevi;2005;181280;0;181280;100
3522604;Itapira;2005;60847;5249;66096;92,06
3522653;Itapirapuã Paulista;2005;1765;2012;3777;46,73
3522703;Itápolis;2005;34122;4921;39043;87,4
3522802;Itaporanga;2005;10441;4077;14518;71,92
3522901;Itapuí;2005;10493;766;11259;93,2
3523008;Itapura;2005;3400;670;4070;83,54
3523107;Itaquaquecetuba;2005;297461;0;297461;100
3523206;Itararé;2005;43480;4176;47656;91,24
3523305;Itariri;2005;8563;5987;14550;58,85
3523404;Itatiba;2005;74828;16521;91349;81,91
3523503;Itatinga;2005;14877;1859;16736;88,89
3523602;Itirapina;2005;12461;1753;14214;87,67
3523701;Itirapuã;2005;4621;1074;5695;81,14
3523800;Itobi;2005;6487;1047;7534;86,1
3523909;Itu;2005;133458;11511;144969;92,06
3524006;Itupeva;2005;27259;7805;35064;77,74
3524105;Ituverava;2005;35275;2370;37645;93,7
3524204;Jaborandi;2005;6000;499;6499;92,32
3524303;Jaboticabal;2005;66543;3299;69842;95,28
3524402;Jacareí;2005;195251;6383;201634;96,83
3524501;Jaci;2005;3791;1087;4878;77,72
3524600;Jacupiranga;2005;9675;7530;17205;56,23
3524709;Jaguariúna;2005;34547;2205;36752;94
3524808;Jales;2005;43240;3497;46737;92,52
3524907;Jambeiro;2005;2220;2466;4686;47,38
3525003;Jandira;2005;100414;0;100414;100
3525102;Jardinópolis;2005;31774;2342;34116;93,14
3525201;Jarinu;2005;14565;5828;20393;71,42
3525300;Jaú;2005;116333;5127;121460;95,78
3525409;Jeriquara;2005;2555;683;3238;78,91
3525508;Joanópolis;2005;11094;0;11094;100
3525607;João Ramalho;2005;3293;692;3985;82,63
3525706;José Bonifácio;2005;27131;3667;30798;88,09
3525805;Júlio Mesquita;2005;4023;313;4336;92,78
3525854;Jumirim;2005;1329;1168;2497;53,22
3525904;Jundiaí;2005;325433;21270;346703;93,87
3526001;Junqueirópolis;2005;14361;3509;17870;80,36
3526100;Juquiá;2005;12259;7868;20127;60,91
3526209;Juquitiba;2005;19612;8263;27875;70,36
3526308;Lagoinha;2005;3012;1890;4902;61,44
3526407;Laranjal Paulista;2005;20974;2764;23738;88,36
3526506;Lavínia;2005;4197;2745;6942;60,46
3526605;Lavrinhas;2005;5656;643;6299;89,79
3526704;Leme;2005;83479;2947;86426;96,59
3526803;Lençóis Paulista;2005;55975;2409;58384;95,87
3526902;Limeira;2005;251980;10928;262908;95,84
3527009;Lindóia;2005;5605;396;6001;93,4
3527108;Lins;2005;67265;1567;68832;97,72
3527207;Lorena;2005;77461;2921;80382;96,37
3527256;Lourdes;2005;1642;423;2065;79,52
3527306;Louveira;2005;27868;2237;30105;92,57
3527405;Lucélia;2005;16420;2757;19177;85,62
3527504;Lucianópolis;2005;1709;523;2232;76,57
3527603;Luís Antônio;2005;8414;765;9179;91,67
3527702;Luiziânia;2005;4128;507;4635;89,06
3527801;Lupércio;2005;2848;1459;4307;66,12
3527900;Lutécia;2005;2146;680;2826;75,94
3528007;Macatuba;2005;15351;711;16062;95,57
3528106;Macaubal;2005;6387;1114;7501;85,15
3528205;Macedônia;2005;2729;1006;3735;73,07
3528304;Magda;2005;2693;613;3306;81,46
3528403;Mairinque;2005;34318;7224;41542;82,61
3528502;Mairiporã;2005;57945;12476;70421;82,28
3528601;Manduri;2005;7022;1628;8650;81,18
3528700;Marabá Paulista;2005;2092;2172;4264;49,06
3528809;Maracaí;2005;11725;1467;13192;88,88
3528858;Marapoama;2005;1832;620;2452;74,71
3528908;Mariápolis;2005;2964;921;3885;76,29
3529005;Marília;2005;197792;9637;207429;95,35
3529104;Marinópolis;2005;1656;527;2183;75,86
3529203;Martinópolis;2005;19100;4167;23267;82,09
3529302;Matão;2005;72134;2496;74630;96,66
3529401;Mauá;2005;391589;0;391589;100
3529500;Mendonça;2005;3224;963;4187;77
3529609;Meridiano;2005;2660;1303;3963;67,12
3529658;Mesópolis;2005;1336;579;1915;69,77
3529708;Miguelópolis;2005;18367;1383;19750;93
3529807;Mineiros do Tietê;2005;11214;563;11777;95,22
3529906;Miracatu;2005;10725;10957;21682;49,46
3530003;Mira Estrela;2005;1909;823;2732;69,88
3530102;Mirandópolis;2005;23321;3420;26741;87,21
3530201;Mirante do Paranapanema;2005;9938;6705;16643;59,71
3530300;Mirassol;2005;49335;1725;51060;96,62
3530409;Mirassolândia;2005;3289;721;4010;82,02
3530508;Mococa;2005;59122;7139;66261;89,23
3530607;Mogi das Cruzes;2005;327724;31712;359436;91,18
3530706;Mogi-Guaçu;2005;122832;8152;130984;93,78
3530805;Moji Mirim;2005;76786;7250;84036;91,37
3530904;Mombuca;2005;2459;732;3191;77,06
3531001;Monções;2005;1786;319;2105;84,85
3531100;Mongaguá;2005;40474;177;40651;99,56
3531209;Monte Alegre do Sul;2005;3658;3073;6731;54,35
3531308;Monte Alto;2005;42561;2668;45229;94,1
3531407;Monte Aprazível;2005;17740;2242;19982;88,78
3531506;Monte Azul Paulista;2005;17625;1761;19386;90,92
3531605;Monte Castelo;2005;3105;976;4081;76,08
3531704;Monteiro Lobato;2005;1628;2236;3864;42,13
3531803;Monte Mor;2005;39402;3655;43057;91,51
3531902;Morro Agudo;2005;25159;2059;27218;92,44
3532009;Morungaba;2005;8836;2014;10850;81,44
3532058;Motuca;2005;2753;1333;4086;67,38
3532108;Murutinga do Sul;2005;2578;1506;4084;63,12
3532157;Nantes;2005;2009;499;2508;80,1
3532207;Narandiba;2005;2657;1359;4016;66,16
3532306;Natividade da Serra;2005;2815;4018;6833;41,2
3532405;Nazaré Paulista;2005;8981;6485;15466;58,07
3532504;Neves Paulista;2005;7827;1040;8867;88,27
3532603;Nhandeara;2005;8270;2217;10487;78,86
3532702;Nipoã;2005;3251;465;3716;87,49
3532801;Nova Aliança;2005;4192;1129;5321;78,78
3532827;Nova Campina;2005;4720;3229;7949;59,38
3532843;Nova Canaã Paulista;2005;850;1464;2314;36,73
3532868;Nova Castilho;2005;600;445;1045;57,42
3532900;Nova Europa;2005;7443;782;8225;90,49
3533007;Nova Granada;2005;16329;1725;18054;90,45
3533106;Nova Guataporanga;2005;1806;340;2146;84,16
3533205;Nova Independência;2005;1911;633;2544;75,12
3533254;Novais;2005;3326;531;3857;86,23
3533304;Nova Lusitânia;2005;2656;417;3073;86,43
3533403;Nova Odessa;2005;45854;901;46755;98,07
3533502;Novo Horizonte;2005;31338;3197;34535;90,74
3533601;Nuporanga;2005;5598;974;6572;85,18
3533700;Ocauçu;2005;3105;1073;4178;74,32
3533809;Óleo;2005;1764;1073;2837;62,18
3533908;Olímpia;2005;44829;3227;48056;93,28
3534005;Onda Verde;2005;2653;1018;3671;72,27
3534104;Oriente;2005;5362;652;6014;89,16
3534203;Orindiúva;2005;4370;511;4881;89,53
3534302;Orlândia;2005;36867;1157;38024;96,96
3534401;Osasco;2005;661677;0;661677;100
3534500;Oscar Bressane;2005;2009;520;2529;79,44
3534609;Osvaldo Cruz;2005;26927;3527;30454;88,42
3534708;Ourinhos;2005;94537;4118;98655;95,83
3534757;Ouroeste;2005;5913;1396;7309;80,9
3534807;Ouro Verde;2005;6741;751;7492;89,98
3534906;Pacaembu;2005;9608;3286;12894;74,52
3535002;Palestina;2005;8136;1884;10020;81,2
3535101;Palmares Paulista;2005;9258;396;9654;95,9
3535200;Palmeira d'Oeste;2005;7174;2855;10029;71,53
3535309;Palmital;2005;18042;2935;20977;86,01
3535408;Panorama;2005;13379;776;14155;94,52
3535507;Paraguaçu Paulista;2005;37412;3660;41072;91,09
3535606;Paraibuna;2005;5272;12032;17304;30,47
3535705;Paraíso;2005;4799;862;5661;84,77
3535804;Paranapanema;2005;12955;3773;16728;77,45
3535903;Paranapuã;2005;3205;553;3758;85,28
3536000;Parapuã;2005;8693;2344;11037;78,76
3536109;Pardinho;2005;3616;1531;5147;70,25
3536208;Pariquera-Açu;2005;12162;5949;18111;67,15
3536257;Parisi;2005;1571;427;1998;78,63
3536307;Patrocínio Paulista;2005;9488;2688;12176;77,92
3536406;Paulicéia;2005;4539;1288;5827;77,9
3536505;Paulínia;2005;65999;215;66214;99,68
3536570;Paulistânia;2005;1100;689;1789;61,49
3536604;Paulo de Faria;2005;7591;982;8573;88,55
3536703;Pederneiras;2005;36200;2891;39091;92,6
3536802;Pedra Bela;2005;1316;4368;5684;23,15
3536901;Pedranópolis;2005;1617;1043;2660;60,79
3537008;Pedregulho;2005;11225;4152;15377;73
3537107;Pedreira;2005;37447;1027;38474;97,33
3537156;Pedrinhas Paulista;2005;2392;522;2914;82,09
3537206;Pedro de Toledo;2005;6562;3200;9762;67,22
3537305;Penápolis;2005;53094;3582;56676;93,68
3537404;Pereira Barreto;2005;23194;1848;25042;92,62
3537503;Pereiras;2005;4541;2242;6783;66,95
3537602;Peruíbe;2005;54370;1412;55782;97,47
3537701;Piacatu;2005;4209;737;4946;85,1
3537800;Piedade;2005;22866;28510;51376;44,51
3537909;Pilar do Sul;2005;19011;6328;25339;75,03
3538006;Pindamonhangaba;2005;129530;7409;136939;94,59
3538105;Pindorama;2005;13100;1005;14105;92,87
3538204;Pinhalzinho;2005;5825;6200;12025;48,44
3538303;Piquerobi;2005;2559;954;3513;72,84
3538501;Piquete;2005;13693;1010;14703;93,13
3538600;Piracaia;2005;24323;0;24323;100
3538709;Piracicaba;2005;335613;11747;347360;96,62
3538808;Piraju;2005;24912;3522;28434;87,61
3538907;Pirajuí;2005;17281;4204;21485;80,43
3539004;Pirangi;2005;9092;1255;10347;87,87
3539103;Pirapora do Bom Jesus;2005;14109;0;14109;100
3539202;Pirapozinho;2005;22025;1486;23511;93,68
3539301;Pirassununga;2005;60738;6831;67569;89,89
3539400;Piratininga;2005;9552;1821;11373;83,99
3539509;Pitangueiras;2005;31472;1883;33355;94,35
3539608;Planalto;2005;3259;787;4046;80,55
3539707;Platina;2005;2305;734;3039;75,85
3539806;Poá;2005;99199;1566;100765;98,45
3539905;Poloni;2005;4517;539;5056;89,34
3540002;Pompéia;2005;17605;1525;19130;92,03
3540101;Pongaí;2005;2915;687;3602;80,93
3540200;Pontal;2005;33491;1251;34742;96,4
3540259;Pontalinda;2005;3006;800;3806;78,98
3540309;Pontes Gestal;2005;2028;488;2516;80,6
3540408;Populina;2005;3416;926;4342;78,67
3540507;Porangaba;2005;3712;3805;7517;49,38
3540606;Porto Feliz;2005;38695;8649;47344;81,73
3540705;Porto Ferreira;2005;47810;1636;49446;96,69
3540754;Potim;2005;13765;2691;16456;83,65
3540804;Potirendaba;2005;12594;1916;14510;86,8
3540853;Pracinha;2005;1270;881;2151;59,04
3540903;Pradópolis;2005;13787;1250;15037;91,69
3541000;Praia Grande;2005;227325;0;227325;100
3541059;Pratânia;2005;3070;1219;4289;71,58
3541109;Presidente Alves;2005;3370;836;4206;80,12
3541208;Presidente Bernardes;2005;10322;3916;14238;72,5
3541307;Presidente Epitácio;2005;37384;3022;40406;92,52
3541406;Presidente Prudente;2005;193841;4972;198813;97,5
3541505;Presidente Venceslau;2005;35405;2394;37799;93,67
3541604;Promissão;2005;27734;5667;33401;83,03
3541653;Quadra;2005;744;2178;2922;25,46
3541703;Quatá;2005;11241;930;12171;92,36
3541802;Queiroz;2005;1984;525;2509;79,08
3541901;Queluz;2005;8515;1752;10267;82,94
3542008;Quitana;2005;5192;531;5723;90,72
3542107;Rafard;2005;7373;1132;8505;86,69
3542206;Rancharia;2005;25393;3581;28974;87,64
3542305;Redenção da Serra;2005;1898;2061;3959;47,94
3542404;Regente Feijó;2005;16093;1684;17777;90,53
3542503;Reginópolis;2005;4048;1987;6035;67,08
3542602;Registro;2005;45404;9005;54409;83,45
3542701;Restinga;2005;4607;1478;6085;75,71
3542800;Ribeira;2005;1117;2359;3476;32,13
3542909;Ribeirão Bonito;2005;10549;1144;11693;90,22
3543006;Ribeirão Branco;2005;9129;11006;20135;45,34
3543105;Ribeirão Corrente;2005;3154;920;4074;77,42
3543204;Ribeirão do Sul;2005;3066;1413;4479;68,45
3543238;Ribeirão dos Índios;2005;1803;412;2215;81,4
3543253;Ribeirão Grande;2005;2333;5114;7447;31,33
3543303;Ribeirão Pires;2005;109279;0;109279;100
3543402;Ribeirão Preto;2005;552834;2162;554996;99,61
3543501;Riversul;2005;4760;1978;6738;70,64
3543600;Rifaina;2005;2932;475;3407;86,06
3543709;Rincão;2005;8356;2068;10424;80,16
3543808;Rinópolis;2005;8275;1825;10100;81,93
3543907;Rio Claro;2005;172041;5026;177067;97,16
3544004;Rio das Pedras;2005;24957;1418;26375;94,62
3544103;Rio Grande da Serra;2005;40661;0;40661;100
3544202;Riolândia;2005;7570;1925;9495;79,73
3544251;Rosana;2005;9911;12282;22193;44,66
3544301;Roseira;2005;8502;576;9078;93,65
3544400;Rubiácea;2005;1408;1103;2511;56,07
3544509;Rubinéia;2005;2107;641;2748;76,67
3544608;Sabino;2005;4319;719;5038;85,73
3544707;Sagres;2005;1691;720;2411;70,14
3544806;Sales;2005;4170;815;4985;83,65
3544905;Sales Oliveira;2005;8647;1270;9917;87,19
3545001;Salesópolis;2005;9298;5758;15056;61,76
3545100;Salmourão;2005;3921;692;4613;85
3545159;Saltinho;2005;5308;1076;6384;83,15
3545209;Salto;2005;98042;1386;99428;98,61
3545308;Salto de Pirapora;2005;29271;8390;37661;77,72
3545407;Salto Grande;2005;7645;1029;8674;88,14
3545506;Sandovalina;2005;2125;1272;3397;62,56
3545605;Santa Adélia;2005;12783;1152;13935;91,73
3545704;Santa Albertina;2005;4654;1029;5683;81,89
3545803;Santa Bárbara d'Oeste;2005;172813;2498;175311;98,58
3546009;Santa Branca;2005;11960;1482;13442;88,97
3546108;Santa Clara d'Oeste;2005;1514;605;2119;71,45
3546207;Santa Cruz da Conceição;2005;2281;1485;3766;60,57
3546256;Santa Cruz da Esperança;2005;1256;632;1888;66,53
3546306;Santa Cruz das Palmeiras;2005;26352;1373;27725;95,05
3546405;Santa Cruz do Rio Pardo;2005;37478;5045;42523;88,14
3546504;Santa Ernestina;2005;4753;919;5672;83,8
3546603;Santa Fé do Sul;2005;26402;1562;27964;94,41
3546702;Santa Gertrudes;2005;18164;526;18690;97,19
3546801;Santa Isabel;2005;35972;11322;47294;76,06
3546900;Santa Lucia;2005;7379;633;8012;92,1
3547007;Santa Maria da Serra;2005;4306;706;5012;85,91
3547106;Santa Mercedes;2005;2342;502;2844;82,35
3547205;Santana da Ponte Pensa;2005;1101;668;1769;62,24
3547304;Santana de Parnaíba;2005;91157;0;91157;100
3547403;Santa Rita d'Oeste;2005;1661;985;2646;62,77
3547502;Santa Rita do Passa Quatro;2005;23137;3258;26395;87,66
3547601;Santa Rosa do Viterbo;2005;21407;1218;22625;94,62
3547650;Santa Salete;2005;665;760;1425;46,67
3547700;Santo Anastácio;2005;19054;1651;20705;92,03
3547809;Santo André;2005;664321;0;664321;100
3547908;Santo Antonio da Alegria;2005;4415;1658;6073;72,7
3548005;Santo Antonio da Posse;2005;16593;2813;19406;85,5
3548054;Santo Antonio do Aracanguá;2005;5198;2088;7286;71,34
3548104;Santo Antonio do Jardim;2005;3394;2675;6069;55,92
3548203;Santo Antonio do Pinhal;2005;3410;3008;6418;53,13
3548302;Santo Expedito;2005;2225;435;2660;83,65
3548401;Santópolis do Aguapeí;2005;3847;178;4025;95,58
3548500;Santos;2005;418964;836;419800;99,8
3548609;São Bento do Sapucaí;2005;4827;5615;10442;46,23
3548708;São Bernardo do Campo;2005;718710;15886;734596;97,84
3548807;São Caetano do Sul;2005;144647;0;144647;100
3548906;São Carlos;2005;197348;10097;207445;95,13
3549003;São Francisco;2005;2109;739;2848;74,05
3549102;São João da Boa Vista;2005;75741;5008;80749;93,8
3549201;São João das Duas Pontes;2005;1988;642;2630;75,59
3549250;São João de Iracema;2005;1293;437;1730;74,74
3549300;São João do Pau d'Alho;2005;1657;498;2155;76,89
3549409;São Joaquim da Barra;2005;43113;973;44086;97,79
3549508;São José da Bela Vista;2005;7205;1065;8270;87,12
3549607;São José do Barreiro;2005;2659;1460;4119;64,55
3549706;São José do Rio Pardo;2005;43677;7529;51206;85,3
3549805;São José do Rio Preto;2005;358949;24232;383181;93,68
3549904;São José dos Campos;2005;572214;12097;584311;97,93
3549953;São Lourenço da Serra;2005;11667;1468;13135;88,82
3550001;São Luís do Paraitinga;2005;6157;4322;10479;58,76
3550100;São Manuel;2005;35593;2027;37620;94,61
3550209;São Miguel Arcanjo;2005;19628;11623;31251;62,81
3550308;São Paulo;2005;10441139;424434;10865573;96,09
3550407;São Pedro;2005;24366;5448;29814;81,73
3550506;São Pedro do Turvo;2005;4755;2318;7073;67,23
3550605;São Roque;2005;58865;14217;73082;80,55
3550704;São Sebastião;2005;65121;695;65816;98,94
3550803;São Sebastião da Grama;2005;7719;4634;12353;62,49
3550902;São Simão;2005;12417;1643;14060;88,31
3551009;São Vicente;2005;318026;296;318322;99,91
3551108;Sarapuí;2005;5808;2667;8475;68,53
3551207;Sarutaiá;2005;2883;777;3660;78,77
3551306;Sebastianópolis do Sul;2005;1963;808;2771;70,84
3551405;Serra Azul;2005;7368;1978;9346;78,84
3551504;Serrana;2005;34892;817;35709;97,71
3551603;Serra Negra;2005;21684;3483;25167;86,16
3551702;Sertãozinho;2005;99067;3201;102268;96,87
3551801;Sete Barras;2005;5784;7667;13451;43
3551900;Severínia;2005;13370;1184;14554;91,86
3552007;Silveiras;2005;2649;2968;5617;47,16
3552106;Socorro;2005;22819;11902;34721;65,72
3552205;Sorocaba;2005;531217;9039;540256;98,33
3552304;Sud Mennucci;2005;6343;1038;7381;85,94
3552403;Sumaré;2005;214169;4107;218276;98,12
3552502;Suzano;2005;236127;10158;246285;95,88
3552551;Suzanópolis;2005;2104;972;3076;68,4
3552601;Tabapuã;2005;9727;1178;10905;89,2
3552700;Tabatinga;2005;11291;2620;13911;81,17
3552809;Taboão da Serra;2005;221494;0;221494;100
3552908;Taciba;2005;4530;954;5484;82,6
3553005;Taguaí;2005;7023;2053;9076;77,38
3553104;Taiaçu;2005;5082;691;5773;88,03
3553203;Taiúva;2005;4858;643;5501;88,31
3553302;Tambaú;2005;19451;2992;22443;86,67
3553401;Tanabi;2005;19755;3605;23360;84,57
3553500;Tapiraí;2005;5715;2661;8376;68,23
3553609;Tapiratiba;2005;9819;3075;12894;76,15
3553658;Taquaral;2005;2595;147;2742;94,64
3553708;Taquaritinga;2005;49291;3942;53233;92,59
3553807;Taquarituba;2005;18914;3281;22195;85,22
3553856;Taquarivaí;2005;2521;2326;4847;52,01
3553906;Tarabaí;2005;5642;568;6210;90,85
3553955;Tarumã;2005;10800;961;11761;91,83
3554003;Tatuí;2005;93346;7131;100477;92,9
3554102;Taubaté;2005;250009;11661;261670;95,54
3554201;Tejupá;2005;2897;2214;5111;56,68
3554300;Teodoro Sampaio;2005;16619;4184;20803;79,89
3554409;Terra Roxa;2005;7643;466;8109;94,25
3554508;Tietê;2005;30804;3407;34211;90,04
3554607;Timburi;2005;1866;835;2701;69,09
3554656;Torre de Pedra;2005;1361;849;2210;61,58
3554706;Torrinha;2005;7589;1481;9070;83,67
3554755;Trabiju;2005;1319;142;1461;90,28
3554805;Tremembé;2005;33150;4773;37923;87,41
3554904;Três Fronteiras;2005;4319;1010;5329;81,05
3554953;Tuiuti;2005;2587;2852;5439;47,56
3555000;Tupã;2005;60601;3078;63679;95,17
3555109;Tupi Paulista;2005;11037;2805;13842;79,74
3555208;Turiúba;2005;1534;380;1914;80,15
3555307;Turmalina;2005;1476;715;2191;67,37
3555356;Ubarana;2005;4280;502;4782;89,5
3555406;Ubatuba;2005;70423;2652;73075;96,37
3555505;Ubirajara;2005;3108;1161;4269;72,8
3555604;Uchôa;2005;8318;946;9264;89,79
3555703;União Paulista;2005;1091;396;1487;73,37
3555802;Urânia;2005;7242;1632;8874;81,61
3555901;Uru;2005;1032;291;1323;78
3556008;Urupês;2005;10508;1819;12327;85,24
3556107;Valentim Gentil;2005;8689;1102;9791;88,74
3556206;Valinhos;2005;89009;5764;94773;93,92
3556305;Valparaíso;2005;18552;1938;20490;90,54
3556354;Vargem;2005;3388;4501;7889;42,95
3556404;Vargem Grande do Sul;2005;35377;2423;37800;93,59
3556453;Vargem Grande Paulista;2005;37722;0;37722;100
3556503;Várzea Paulista;2005;99778;0;99778;100
3556602;Vera Cruz;2005;9258;1725;10983;84,29
3556701;Vinhedo;2005;53123;2042;55165;96,3
3556800;Viradouro;2005;15885;754;16639;95,47
3556909;Vista Alegre do Alto;2005;5113;680;5793;88,26
3556958;Vitória Brasil;2005;1305;402;1707;76,45
3557006;Votorantim;2005;98391;4288;102679;95,82
3557105;Votuporanga;2005;77270;2990;80260;96,27
3557154;Zacarias;2005;1559;578;2137;72,95
3557204;Chavantes;2005;10771;1398;12169;88,51
3557303;Estiva Gerbi;2005;7811;1658;9469;82,49
3500105;Adamantina;2010;31945;1849;33794;94,53
3500204;Adolfo;2010;3201;357;3558;89,97
3500303;Aguaí;2010;28969;3144;32113;90,21
3500402;Águas da Prata;2010;6767;813;7580;89,27
3500501;Águas de Lindóia;2010;17102;155;17257;99,1
3500550;Águas de Santa Bárbara;2010;4257;1341;5598;76,05
3500600;Águas de São Pedro;2010;2699;0;2699;100
3500709;Agudos;2010;32976;1530;34506;95,57
3500758;Alambari;2010;3663;1209;4872;75,18
3500808;Alfredo Marcondes;2010;3253;636;3889;83,65
3500907;Altair;2010;3020;793;3813;79,2
3501004;Altinópolis;2010;13635;1971;15606;87,37
3501103;Alto Alegre;2010;3235;868;4103;78,84
3501152;Alumínio;2010;14111;2714;16825;83,87
3501202;Álvares Florence;2010;2650;1250;3900;67,95
3501301;Álvares Machado;2010;21177;2329;23506;90,09
3501400;Álvaro de Carvalho;2010;2949;1696;4645;63,49
3501509;Alvinlândia;2010;2692;307;2999;89,76
3501608;Americana;2010;209404;983;210387;99,53
3501707;Américo Brasiliense;2010;34160;261;34421;99,24
3501806;Américo de Campos;2010;4787;918;5705;83,91
3501905;Amparo;2010;51774;14008;65782;78,71
3502002;Analândia;2010;3403;884;4287;79,38
3502101;Andradina;2010;51648;3685;55333;93,34
3502200;Angatuba;2010;15934;6250;22184;71,83
3502309;Anhembi;2010;4263;1380;5643;75,54
3502408;Anhumas;2010;3057;678;3735;81,85
3502507;Aparecida;2010;34497;509;35006;98,55
3502606;Aparecida d'Oeste;2010;3648;806;4454;81,9
3502705;Apiaí;2010;18230;6977;25207;72,32
3502754;Araçariguama;2010;17019;0;17019;100
3502804;Araçatuba;2010;177973;3500;181473;98,07
3502903;Araçoiaba da Serra;2010;18714;8512;27226;68,74
3503000;Aramina;2010;4813;336;5149;93,47
3503109;Arandu;2010;4614;1509;6123;75,36
3503158;Arapeí;2010;1876;618;2494;75,22
3503208;Araraquara;2010;202504;5925;208429;97,16
3503307;Araras;2010;112321;6392;118713;94,62
3503356;Arco-Íris;2010;1098;829;1927;56,98
3503406;Arealva;2010;6172;1664;7836;78,76
3503505;Areias;2010;2477;1218;3695;67,04
3503604;Areiópolis;2010;9399;1178;10577;88,86
3503703;Ariranha;2010;8085;452;8537;94,71
3503802;Artur Nogueira;2010;39902;4169;44071;90,54
3503901;Arujá;2010;71775;2983;74758;96,01
3503950;Aspásia;2010;1257;552;1809;69,49
3504008;Assis;2010;90925;4150;95075;95,64
3504107;Atibaia;2010;115105;11362;126467;91,02
3504206;Auriflama;2010;12943;1253;14196;91,17
3504305;Avaí;2010;3328;1628;4956;67,15
3504404;Avanhandava;2010;9544;1743;11287;84,56
3504503;Avaré;2010;79337;3541;82878;95,73
3504602;Bady Bassitt;2010;13632;942;14574;93,54
3504701;Balbinos;2010;1181;2489;3670;32,18
3504800;Bálsamo;2010;7468;685;8153;91,6
3504909;Bananal;2010;8154;2065;10219;79,79
3505005;Barão de Antonina;2010;1911;1202;3113;61,39
3505104;Barbosa;2010;5569;1017;6586;84,56
3505203;Bariri;2010;29947;1616;31563;94,88
3505302;Barra Bonita;2010;34509;739;35248;97,9
3505351;Barra do Chapéu;2010;1543;3698;5241;29,44
3505401;Barra do Turvo;2010;3175;4557;7732;41,06
3505500;Barretos;2010;108617;3413;112030;96,95
3505609;Barrinha;2010;28141;316;28457;98,89
3505708;Barueri;2010;240459;0;240459;100
3505807;Bastos;2010;17609;2837;20446;86,12
3505906;Batatais;2010;49903;6526;56429;88,44
3506003;Bauru;2010;337946;5749;343695;98,33
3506102;Bebedouro;2010;71501;3532;75033;95,29
3506201;Bento de Abreu;2010;2442;230;2672;91,39
3506300;Bernardino de Campos;2010;9658;1117;10775;89,63
3506359;Bertioga;2010;46687;775;47462;98,37
3506409;Bilac;2010;6473;566;7039;91,96
3506508;Birigui;2010;105362;3237;108599;97,02
3506607;Biritiba Mirim;2010;24495;4045;28540;85,83
3506706;Boa Esperança do Sul;2010;12176;1460;13636;89,29
3506805;Bocaina;2010;9994;852;10846;92,14
3506904;Bofete;2010;6119;3478;9597;63,76
3507001;Boituva;2010;45319;2858;48177;94,07
3507100;Bom Jesus dos Perdões;2010;17320;2324;19644;88,17
3507159;Bom Sucesso de Itararé;2010;2428;1140;3568;68,05
3507209;Borá;2010;627;178;805;77,89
3507308;Boracéia;2010;3823;440;4263;89,68
3507407;Borborema;2010;13084;1433;14517;90,13
3507456;Borebi;2010;1997;293;2290;87,21
3507506;Botucatu;2010;122512;4644;127156;96,35
3507605;Bragança Paulista;2010;142065;4483;146548;96,94
3507704;Braúna;2010;4385;630;5015;87,44
3507753;Brejo Alegre;2010;2108;463;2571;81,99
3507803;Brodowski;2010;20561;509;21070;97,58
3507902;Brotas;2010;18578;2978;21556;86,18
3508009;Buri;2010;14986;3569;18555;80,77
3508108;Buritama;2010;14513;891;15404;94,22
3508207;Buritizal;2010;3304;746;4050;81,58
3508306;Cabrália Paulista;2010;3779;588;4367;86,54
3508405;Cabreúva;2010;35194;6331;41525;84,75
3508504;Caçapava;2010;72452;12224;84676;85,56
3508603;Cachoeira Paulista;2010;24552;5514;30066;81,66
3508702;Caconde;2010;12638;5899;18537;68,18
3508801;Cafelândia;2010;14420;2180;16600;86,87
3508900;Caiabu;2010;3315;757;4072;81,41
3509007;Caieiras;2010;84249;2140;86389;97,52
3509106;Caiuá;2010;1927;3104;5031;38,3
3509205;Cajamar;2010;62701;1288;63989;97,99
3509254;Cajati;2010;20725;7654;28379;73,03
3509304;Cajobi;2010;9128;635;9763;93,5
3509403;Cajuru;2010;20775;2573;23348;88,98
3509452;Campina do Monte Alegre;2010;4707;857;5564;84,6
3509502;Campinas;2010;1060584;18556;1079140;98,28
3509601;Campo Limpo Paulista;2010;73981;0;73981;100
3509700;Campos do Jordão;2010;47460;298;47758;99,38
3509809;Campos Novos Paulista;2010;3526;1010;4536;77,73
3509908;Cananéia;2010;10437;1790;12227;85,36
3509957;Canas;2010;4064;314;4378;92,83
3510005;Cândido Mota;2010;28091;1788;29879;94,02
3510104;Cândido Rodrigues;2010;2153;515;2668;80,7
3510153;Canitar;2010;4130;231;4361;94,7
3510203;Capão Bonito;2010;37828;8355;46183;81,91
3510302;Capela do Alto;2010;14497;3005;17502;82,83
3510401;Capivari;2010;45844;2668;48512;94,5
3510500;Caraguatatuba;2010;96476;4158;100634;95,87
3510609;Carapicuíba;2010;369368;0;369368;100
3510708;Cardoso;2010;10728;1075;11803;90,89
3510807;Casa Branca;2010;23143;5151;28294;81,79
3510906;Cássia dos Coqueiros;2010;1796;840;2636;68,13
3511003;Castilho;2010;13565;4410;17975;75,47
3511102;Catanduva;2010;111854;906;112760;99,2
3511201;Catiguá;2010;6564;558;7122;92,17
3511300;Cedral;2010;6298;1662;7960;79,12
3511409;Cerqueira César;2010;15697;1814;17511;89,64
3511508;Cerquilho;2010;37475;2045;39520;94,83
3511607;Cesário Lange;2010;10476;5040;15516;67,52
3511706;Charqueada;2010;13670;1397;15067;90,73
3511904;Clementina;2010;6719;330;7049;95,32
3512001;Colina;2010;16217;1148;17365;93,39
3512100;Colômbia;2010;4332;1662;5994;72,27
3512209;Conchal;2010;23818;1389;25207;94,49
3512308;Conchas;2010;13187;3089;16276;81,02
3512407;Cordeirópolis;2010;18905;2143;21048;89,82
3512506;Coroados;2010;4236;995;5231;80,98
3512605;Coronel Macedo;2010;3869;1137;5006;77,29
3512704;Corumbataí;2010;2092;1781;3873;54,01
3512803;Cosmópolis;2010;54506;4183;58689;92,87
3512902;Cosmorama;2010;4946;2269;7215;68,55
3513009;Cotia;2010;200647;0;200647;100
3513108;Cravinhos;2010;30874;788;31662;97,51
3513207;Cristais Paulista;2010;5521;2058;7579;72,85
3513306;Cruzália;2010;1512;765;2277;66,4
3513405;Cruzeiro;2010;75047;1962;77009;97,45
3513504;Cubatão;2010;118629;0;118629;100
3513603;Cunha;2010;12173;9703;21876;55,65
3513702;Descalvado;2010;27696;3342;31038;89,23
3513801;Diadema;2010;385838;0;385838;100
3513850;Dirce Reis;2010;1278;410;1688;75,71
3513900;Divinolândia;2010;7505;3710;11215;66,92
3514007;Dobrada;2010;7754;177;7931;97,77
3514106;Dois Córregos;2010;23427;1314;24741;94,69
3514205;Dolcinópolis;2010;1949;147;2096;92,99
3514304;Dourado;2010;7869;740;8609;91,4
3514403;Dracena;2010;39924;3310;43234;92,34
3514502;Duartina;2010;10999;1254;12253;89,77
3514601;Dumont;2010;7838;288;8126;96,46
3514700;Echaporã;2010;5035;1287;6322;79,64
3514809;Eldorado;2010;7203;7434;14637;49,21
3514908;Elias Fausto;2010;12544;3214;15758;79,6
3514924;Elisiário;2010;2853;262;3115;91,59
3514957;Embaúba;2010;2060;363;2423;85,02
3515004;Embu;2010;239939;0;239939;100
3515103;Embu-Guaçu;2010;61045;1673;62718;97,33
3515129;Emilianópolis;2010;2496;523;3019;82,68
3515152;Engenheiro Coelho;2010;11455;4207;15662;73,14
3515186;Espírito Santo do Pinhal;2010;37234;4661;41895;88,87
3515194;Espírito Santo do Turvo;2010;3626;613;4239;85,54
3515202;Estrela d'Oeste;2010;6831;1377;8208;83,22
3515301;Estrela do Norte;2010;2099;559;2658;78,97
3515350;Euclides da Cunha Paulista;2010;6114;3476;9590;63,75
3515400;Fartura;2010;12236;3081;15317;79,89
3515509;Fernandópolis;2010;62689;1981;64670;96,94
3515608;Fernando Prestes;2010;4697;836;5533;84,89
3515657;Fernão;2010;849;713;1562;54,35
3515707;Ferraz de Vasconcelos;2010;160530;7542;168072;95,51
3515806;Flora Rica;2010;1420;335;1755;80,91
3515905;Floreal;2010;2441;564;3005;81,23
3516002;Flórida Paulista;2010;10124;2708;12832;78,9
3516101;Florínia;2010;2514;317;2831;88,8
3516200;Franca;2010;312780;5589;318369;98,24
3516309;Francisco Morato;2010;153973;314;154287;99,8
3516408;Franco da Rocha;2010;121046;10343;131389;92,13
3516507;Gabriel Monteiro;2010;2257;451;2708;83,35
3516606;Gália;2010;5230;1788;7018;74,52
3516705;Garça;2010;39192;3923;43115;90,9
3516804;Gastão Vidigal;2010;3752;436;4188;89,59
3516853;Gavião Peixoto;2010;3573;843;4416;80,91
3516903;General Salgado;2010;9085;1585;10670;85,15
3517000;Getulina;2010;8332;2430;10762;77,42
3517109;Glicério;2010;3361;1203;4564;73,64
3517208;Guaiçara;2010;9682;975;10657;90,85
3517307;Guaimbê;2010;4738;685;5423;87,37
3517406;Guaíra;2010;36036;1344;37380;96,4
3517505;Guapiaçu;2010;15774;2060;17834;88,45
3517604;Guapiara;2010;7239;10773;18012;40,19
3517703;Guará;2010;19215;635;19850;96,8
3517802;Guaraçai;2010;6657;1782;8439;78,88
3517901;Guaraci;2010;8918;1048;9966;89,48
3518008;Guarani d'Oeste;2010;1735;235;1970;88,07
3518107;Guarantã;2010;5461;942;6403;85,29
3518206;Guararapes;2010;28304;2278;30582;92,55
3518305;Guararema;2010;22209;3599;25808;86,05
3518404;Guaratinguetá;2010;106697;5307;112004;95,26
3518503;Guareí;2010;8388;6134;14522;57,76
3518602;Guariba;2010;34710;737;35447;97,92
3518701;Guarujá;2010;290470;56;290526;99,98
3518800;Guarulhos;2010;1220653;0;1220653;100
3518859;Guatapará;2010;5112;1849;6961;73,44
3518909;Guzolândia;2010;4018;732;4750;84,59
3519006;Herculândia;2010;7916;774;8690;91,09
3519055;Holambra;2010;8154;3103;11257;72,43
3519071;Hortolândia;2010;192317;0;192317;100
3519105;Iacanga;2010;8712;1285;9997;87,15
3519204;Iacri;2010;5052;1370;6422;78,67
3519253;Iaras;2010;2820;3517;6337;44,5
3519303;Ibaté;2010;29472;1224;30696;96,01
3519402;Ibirá;2010;10033;850;10883;92,19
3519501;Ibirarema;2010;6204;512;6716;92,38
3519600;Ibitinga;2010;51001;2099;53100;96,05
3519709;Ibiúna;2010;24912;46245;71157;35,01
3519808;Icém;2010;6399;1057;7456;85,82
3519907;Iepê;2010;6770;855;7625;88,79
3520004;Igaraçu do Tietê;2010;23222;134;23356;99,43
3520103;Igarapava;2010;26345;1589;27934;94,31
3520202;Igaratá;2010;7001;1825;8826;79,32
3520301;Iguape;2010;24677;4152;28829;85,6
3520400;Ilhabela;2010;27931;194;28125;99,31
3520426;Ilha Comprida;2010;9003;0;9003;100
3520442;Ilha Solteira;2010;23512;1543;25055;93,84
3520509;Indaiatuba;2010;199067;2022;201089;98,99
3520608;Indiana;2010;4128;698;4826;85,54
3520707;Indiaporã;2010;3380;524;3904;86,58
3520806;Inúbia Paulista;2010;3174;453;3627;87,51
3520905;Ipaussu;2010;12579;1074;13653;92,13
3521002;Iperó;2010;17400;10798;28198;61,71
3521101;Ipeúna;2010;5164;836;6000;86,07
3521150;Ipiguá;2010;2692;1762;4454;60,44
3521200;Iporanga;2010;2402;1899;4301;55,85
3521309;Ipuã;2010;13542;585;14127;95,86
3521408;Iracemápolis;2010;19575;412;19987;97,94
3521507;Irapuã;2010;6485;785;7270;89,2
3521606;Irapuru;2010;5505;2281;7786;70,7
3521705;Itaberá;2010;12145;5722;17867;67,97
3521804;Itaí;2010;18832;5150;23982;78,53
3521903;Itajobi;2010;12139;2414;14553;83,41
3522000;Itaju;2010;2357;883;3240;72,75
3522109;Itanhaém;2010;86105;814;86919;99,06
3522158;Itaóca;2010;1760;1468;3228;54,52
3522208;Itapecerica da Serra;2010;151144;1263;152407;99,17
3522307;Itapetininga;2010;130898;13311;144209;90,77
3522406;Itapeva;2010;73921;13790;87711;84,28
3522505;Itapevi;2010;200415;0;200415;100
3522604;Itapira;2010;63534;4958;68492;92,76
3522653;Itapirapuã Paulista;2010;1891;1986;3877;48,77
3522703;Itápolis;2010;36307;3724;40031;90,7
3522802;Itaporanga;2010;11031;3516;14547;75,83
3522901;Itapuí;2010;11615;542;12157;95,54
3523008;Itapura;2010;3478;874;4352;79,92
3523107;Itaquaquecetuba;2010;321329;0;321329;100
3523206;Itararé;2010;44259;3663;47922;92,36
3523305;Itariri;2010;9869;5586;15455;63,86
3523404;Itatiba;2010;85507;15776;101283;84,42
3523503;Itatinga;2010;16399;1630;18029;90,96
3523602;Itirapina;2010;13978;1521;15499;90,19
3523701;Itirapuã;2010;4926;984;5910;83,35
3523800;Itobi;2010;6799;746;7545;90,11
3523909;Itu;2010;144113;9867;153980;93,59
3524006;Itupeva;2010;38780;5878;44658;86,84
3524105;Ituverava;2010;36410;2264;38674;94,15
3524204;Jaborandi;2010;6165;426;6591;93,54
3524303;Jaboticabal;2010;69491;2134;71625;97,02
3524402;Jacareí;2010;208125;2915;211040;98,62
3524501;Jaci;2010;4858;784;5642;86,1
3524600;Jacupiranga;2010;9368;7839;17207;54,44
3524709;Jaguariúna;2010;42888;1274;44162;97,12
3524808;Jales;2010;44232;2773;47005;94,1
3524907;Jambeiro;2010;2555;2781;5336;47,88
3525003;Jandira;2010;108195;0;108195;100
3525102;Jardinópolis;2010;36080;1517;37597;95,97
3525201;Jarinu;2010;18377;5403;23780;77,28
3525300;Jaú;2010;126778;4092;130870;96,87
3525409;Jeriquara;2010;2607;554;3161;82,47
3525508;Joanópolis;2010;11756;0;11756;100
3525607;João Ramalho;2010;3540;607;4147;85,36
3525706;José Bonifácio;2010;29651;3076;32727;90,6
3525805;Júlio Mesquita;2010;4212;216;4428;95,12
3525854;Jumirim;2010;1620;1172;2792;58,02
3525904;Jundiaí;2010;353806;15904;369710;95,7
3526001;Junqueirópolis;2010;15387;3324;18711;82,24
3526100;Juquiá;2010;12145;7111;19256;63,07
3526209;Juquitiba;2010;22225;6492;28717;77,39
3526308;Lagoinha;2010;3139;1703;4842;64,83
3526407;Laranjal Paulista;2010;22587;2636;25223;89,55
3526506;Lavínia;2010;4266;4474;8740;48,81
3526605;Lavrinhas;2010;6044;541;6585;91,78
3526704;Leme;2010;89766;1892;91658;97,94
3526803;Lençóis Paulista;2010;59996;1376;61372;97,76
3526902;Limeira;2010;267556;8230;275786;97,02
3527009;Lindóia;2010;6699;0;6699;100
3527108;Lins;2010;70551;834;71385;98,83
3527207;Lorena;2010;80135;2363;82498;97,14
3527256;Lourdes;2010;1743;384;2127;81,95
3527306;Louveira;2010;35564;1425;36989;96,15
3527405;Lucélia;2010;17207;2661;19868;86,61
3527504;Lucianópolis;2010;1779;469;2248;79,14
3527603;Luís Antônio;2010;10859;384;11243;96,58
3527702;Luiziânia;2010;4605;418;5023;91,68
3527801;Lupércio;2010;3864;488;4352;88,79
3527900;Lutécia;2010;2159;556;2715;79,52
3528007;Macatuba;2010;15772;483;16255;97,03
3528106;Macaubal;2010;6771;890;7661;88,38
3528205;Macedônia;2010;2778;887;3665;75,8
3528304;Magda;2010;2657;545;3202;82,98
3528403;Mairinque;2010;34668;8527;43195;80,26
3528502;Mairiporã;2010;70574;10181;80755;87,39
3528601;Manduri;2010;7773;1213;8986;86,5
3528700;Marabá Paulista;2010;2137;2664;4801;44,51
3528809;Maracaí;2010;12082;1247;13329;90,64
3528858;Marapoama;2010;2196;433;2629;83,53
3528908;Mariápolis;2010;3136;779;3915;80,1
3529005;Marília;2010;206860;9716;216576;95,51
3529104;Marinópolis;2010;1672;442;2114;79,09
3529203;Martinópolis;2010;20328;3875;24203;83,99
3529302;Matão;2010;75335;1408;76743;98,17
3529401;Mauá;2010;416585;0;416585;100
3529500;Mendonça;2010;3786;846;4632;81,74
3529609;Meridiano;2010;2675;1181;3856;69,37
3529658;Mesópolis;2010;1468;418;1886;77,84
3529708;Miguelópolis;2010;19254;1185;20439;94,2
3529807;Mineiros do Tietê;2010;11495;538;12033;95,53
3529906;Miracatu;2010;10593;10013;20606;51,41
3530003;Mira Estrela;2010;1880;938;2818;66,71
3530102;Mirandópolis;2010;24443;3027;27470;88,98
3530201;Mirante do Paranapanema;2010;10041;7011;17052;58,88
3530300;Mirassol;2010;52386;1358;53744;97,47
3530409;Mirassolândia;2010;3488;802;4290;81,31
3530508;Mococa;2010;61143;5141;66284;92,24
3530607;Mogi das Cruzes;2010;356835;30425;387260;92,14
3530706;Mogi-Guaçu;2010;130187;6944;137131;94,94
3530805;Moji Mirim;2010;80905;5557;86462;93,57
3530904;Mombuca;2010;2684;581;3265;82,21
3531001;Monções;2010;1835;296;2131;86,11
3531100;Mongaguá;2010;45984;202;46186;99,56
3531209;Monte Alegre do Sul;2010;4087;3058;7145;57,2
3531308;Monte Alto;2010;44518;2098;46616;95,5
3531407;Monte Aprazível;2010;19776;1940;21716;91,07
3531506;Monte Azul Paulista;2010;17718;1218;18936;93,57
3531605;Monte Castelo;2010;3211;852;4063;79,03
3531704;Monteiro Lobato;2010;1776;2340;4116;43,15
3531803;Monte Mor;2010;45875;2964;48839;93,93
3531902;Morro Agudo;2010;27875;1208;29083;95,85
3532009;Morungaba;2010;10036;1716;11752;85,4
3532058;Motuca;2010;3105;1181;4286;72,45
3532108;Murutinga do Sul;2010;2572;1612;4184;61,47
3532157;Nantes;2010;2427;276;2703;89,79
3532207;Narandiba;2010;3101;1182;4283;72,4
3532306;Natividade da Serra;2010;2789;3891;6680;41,75
3532405;Nazaré Paulista;2010;13896;2500;16396;84,75
3532504;Neves Paulista;2010;7917;856;8773;90,24
3532603;Nhandeara;2010;8684;2036;10720;81,01
3532702;Nipoã;2010;3788;476;4264;88,84
3532801;Nova Aliança;2010;4873;1008;5881;82,86
3532827;Nova Campina;2010;5755;2749;8504;67,67
3532843;Nova Canaã Paulista;2010;881;1236;2117;41,62
3532868;Nova Castilho;2010;745;379;1124;66,28
3532900;Nova Europa;2010;8607;674;9281;92,74
3533007;Nova Granada;2010;17757;1404;19161;92,67
3533106;Nova Guataporanga;2010;1889;287;2176;86,81
3533205;Nova Independência;2010;2438;620;3058;79,73
3533254;Novais;2010;4168;410;4578;91,04
3533304;Nova Lusitânia;2010;3082;353;3435;89,72
3533403;Nova Odessa;2010;50324;834;51158;98,37
3533502;Novo Horizonte;2010;34014;2542;36556;93,05
3533601;Nuporanga;2010;6181;632;6813;90,72
3533700;Ocauçu;2010;3324;839;4163;79,85
3533809;Óleo;2010;1765;911;2676;65,96
3533908;Olímpia;2010;47211;2778;49989;94,44
3534005;Onda Verde;2010;3040;840;3880;78,35
3534104;Oriente;2010;5693;402;6095;93,4
3534203;Orindiúva;2010;5209;451;5660;92,03
3534302;Orlândia;2010;38724;1024;39748;97,42
3534401;Osasco;2010;666621;0;666621;100
3534500;Oscar Bressane;2010;2099;438;2537;82,74
3534609;Osvaldo Cruz;2010;27772;3134;30906;89,86
3534708;Ourinhos;2010;100296;2659;102955;97,42
3534757;Ouroeste;2010;7528;857;8385;89,78
3534807;Ouro Verde;2010;7170;624;7794;91,99
3534906;Pacaembu;2010;9741;3479;13220;73,68
3535002;Palestina;2010;9173;1860;11033;83,14
3535101;Palmares Paulista;2010;10596;314;10910;97,12
3535200;Palmeira d'Oeste;2010;7273;2317;9590;75,84
3535309;Palmital;2010;19423;1759;21182;91,7
3535408;Panorama;2010;14157;418;14575;97,13
3535507;Paraguaçu Paulista;2010;38293;3962;42255;90,62
3535606;Paraibuna;2010;5241;12144;17385;30,15
3535705;Paraíso;2010;5184;710;5894;87,95
3535804;Paranapanema;2010;14461;3327;17788;81,3
3535903;Paranapuã;2010;3392;421;3813;88,96
3536000;Parapuã;2010;8898;1948;10846;82,04
3536109;Pardinho;2010;4383;1191;5574;78,63
3536208;Pariquera-Açu;2010;12656;5783;18439;68,64
3536257;Parisi;2010;1642;389;2031;80,85
3536307;Patrocínio Paulista;2010;10488;2498;12986;80,76
3536406;Paulicéia;2010;5263;1067;6330;83,14
3536505;Paulínia;2010;81749;76;81825;99,91
3536570;Paulistânia;2010;1212;567;1779;68,13
3536604;Paulo de Faria;2010;7749;839;8588;90,23
3536703;Pederneiras;2010;38552;2902;41454;93
3536802;Pedra Bela;2010;1440;4339;5779;24,92
3536901;Pedranópolis;2010;1592;967;2559;62,21
3537008;Pedregulho;2010;11579;4115;15694;73,78
3537107;Pedreira;2010;41152;349;41501;99,16
3537156;Pedrinhas Paulista;2010;2479;460;2939;84,35
3537206;Pedro de Toledo;2010;7027;3168;10195;68,93
3537305;Penápolis;2010;55850;2627;58477;95,51
3537404;Pereira Barreto;2010;23236;1727;24963;93,08
3537503;Pereiras;2010;4971;2472;7443;66,79
3537602;Peruíbe;2010;59031;667;59698;98,88
3537701;Piacatu;2010;4658;623;5281;88,2
3537800;Piedade;2010;23752;28374;52126;45,57
3537909;Pilar do Sul;2010;20731;5654;26385;78,57
3538006;Pindamonhangaba;2010;141527;5280;146807;96,4
3538105;Pindorama;2010;14219;803;15022;94,65
3538204;Pinhalzinho;2010;6446;6640;13086;49,26
3538303;Piquerobi;2010;2669;868;3537;75,46
3538501;Piquete;2010;13220;896;14116;93,65
3538600;Piracaia;2010;25101;0;25101;100
3538709;Piracicaba;2010;356440;7821;364261;97,85
3538808;Piraju;2010;25600;2870;28470;89,92
3538907;Pirajuí;2010;18482;4199;22681;81,49
3539004;Pirangi;2010;9524;1094;10618;89,7
3539103;Pirapora do Bom Jesus;2010;15702;0;15702;100
3539202;Pirapozinho;2010;23440;1231;24671;95,01
3539301;Pirassununga;2010;64175;5861;70036;91,63
3539400;Piratininga;2010;10341;1718;12059;85,75
3539509;Pitangueiras;2010;33912;1358;35270;96,15
3539608;Planalto;2010;3760;696;4456;84,38
3539707;Platina;2010;2511;678;3189;78,74
3539806;Poá;2010;104250;1674;105924;98,42
3539905;Poloni;2010;4798;592;5390;89,02
3540002;Pompéia;2010;18559;1389;19948;93,04
3540101;Pongaí;2010;2927;556;3483;84,04
3540200;Pontal;2010;39392;750;40142;98,13
3540259;Pontalinda;2010;3377;692;4069;82,99
3540309;Pontes Gestal;2010;2123;395;2518;84,31
3540408;Populina;2010;3414;811;4225;80,8
3540507;Porangaba;2010;4012;4298;8310;48,28
3540606;Porto Feliz;2010;41072;7792;48864;84,05
3540705;Porto Ferreira;2010;50445;921;51366;98,21
3540754;Potim;2010;14666;4674;19340;75,83
3540804;Potirendaba;2010;13870;1563;15433;89,87
3540853;Pracinha;2010;1361;1481;2842;47,89
3540903;Pradópolis;2010;16060;1274;17334;92,65
3541000;Praia Grande;2010;261391;0;261391;100
3541059;Pratânia;2010;3480;1113;4593;75,77
3541109;Presidente Alves;2010;3433;692;4125;83,22
3541208;Presidente Bernardes;2010;10507;3072;13579;77,38
3541307;Presidente Epitácio;2010;38529;2772;41301;93,29
3541406;Presidente Prudente;2010;203217;4232;207449;97,96
3541505;Presidente Venceslau;2010;36267;1638;37905;95,68
3541604;Promissão;2010;30035;5598;35633;84,29
3541653;Quadra;2010;827;2404;3231;25,6
3541703;Quatá;2010;12002;787;12789;93,85
3541802;Queiroz;2010;2380;422;2802;84,94
3541901;Queluz;2010;9259;2030;11289;82,02
3542008;Quitana;2010;5489;510;5999;91,5
3542107;Rafard;2010;7589;1021;8610;88,14
3542206;Rancharia;2010;25828;2976;28804;89,67
3542305;Redenção da Serra;2010;2214;1660;3874;57,15
3542404;Regente Feijó;2010;17037;1444;18481;92,19
3542503;Reginópolis;2010;4347;2950;7297;59,57
3542602;Registro;2010;48165;6092;54257;88,77
3542701;Restinga;2010;5172;1406;6578;78,63
3542800;Ribeira;2010;1236;2123;3359;36,8
3542909;Ribeirão Bonito;2010;11213;914;12127;92,46
3543006;Ribeirão Branco;2010;9305;8987;18292;50,87
3543105;Ribeirão Corrente;2010;3395;875;4270;79,51
3543204;Ribeirão do Sul;2010;3295;1151;4446;74,11
3543238;Ribeirão dos Índios;2010;1850;337;2187;84,59
3543253;Ribeirão Grande;2010;2344;5078;7422;31,58
3543303;Ribeirão Pires;2010;112994;0;112994;100
3543402;Ribeirão Preto;2010;602061;1713;603774;99,72
3543501;Riversul;2010;4498;1673;6171;72,89
3543600;Rifaina;2010;3007;428;3435;87,54
3543709;Rincão;2010;8459;1954;10413;81,23
3543808;Rinópolis;2010;8639;1299;9938;86,93
3543907;Rio Claro;2010;181566;4529;186095;97,57
3544004;Rio das Pedras;2010;28508;937;29445;96,82
3544103;Rio Grande da Serra;2010;43912;0;43912;100
3544202;Riolândia;2010;8351;2205;10556;79,11
3544251;Rosana;2010;15885;3840;19725;80,53
3544301;Roseira;2010;9107;483;9590;94,96
3544400;Rubiácea;2010;1561;1164;2725;57,28
3544509;Rubinéia;2010;2353;507;2860;82,27
3544608;Sabino;2010;4573;642;5215;87,69
3544707;Sagres;2010;1819;576;2395;75,95
3544806;Sales;2010;4900;543;5443;90,02
3544905;Sales Oliveira;2010;9559;998;10557;90,55
3545001;Salesópolis;2010;9947;5677;15624;63,66
3545100;Salmourão;2010;4317;497;4814;89,68
3545159;Saltinho;2010;5881;1166;7047;83,45
3545209;Salto;2010;104666;741;105407;99,3
3545308;Salto de Pirapora;2010;31428;8659;40087;78,4
3545407;Salto Grande;2010;7930;854;8784;90,28
3545506;Sandovalina;2010;2577;1116;3693;69,78
3545605;Santa Adélia;2010;13552;773;14325;94,6
3545704;Santa Albertina;2010;4890;832;5722;85,46
3545803;Santa Bárbara d'Oeste;2010;178512;1412;179924;99,22
3546009;Santa Branca;2010;12135;1622;13757;88,21
3546108;Santa Clara d'Oeste;2010;1571;513;2084;75,38
3546207;Santa Cruz da Conceição;2010;2705;1293;3998;67,66
3546256;Santa Cruz da Esperança;2010;1322;630;1952;67,73
3546306;Santa Cruz das Palmeiras;2010;28962;931;29893;96,89
3546405;Santa Cruz do Rio Pardo;2010;40130;3765;43895;91,42
3546504;Santa Ernestina;2010;5146;423;5569;92,4
3546603;Santa Fé do Sul;2010;28065;1150;29215;96,06
3546702;Santa Gertrudes;2010;21350;229;21579;98,94
3546801;Santa Isabel;2010;39544;10849;50393;78,47
3546900;Santa Lucia;2010;7751;494;8245;94,01
3547007;Santa Maria da Serra;2010;4766;640;5406;88,16
3547106;Santa Mercedes;2010;2458;373;2831;86,82
3547205;Santana da Ponte Pensa;2010;1098;545;1643;66,83
3547304;Santana de Parnaíba;2010;108474;0;108474;100
3547403;Santa Rita d'Oeste;2010;1774;770;2544;69,73
3547502;Santa Rita do Passa Quatro;2010;23698;2777;26475;89,51
3547601;Santa Rosa do Viterbo;2010;22727;1114;23841;95,33
3547650;Santa Salete;2010;818;628;1446;56,57
3547700;Santo Anastácio;2010;19082;1395;20477;93,19
3547809;Santo André;2010;676177;0;676177;100
3547908;Santo Antonio da Alegria;2010;4665;1634;6299;74,06
3548005;Santo Antonio da Posse;2010;18814;1814;20628;91,21
3548054;Santo Antonio do Aracanguá;2010;5966;1654;7620;78,29
3548104;Santo Antonio do Jardim;2010;3533;2412;5945;59,43
3548203;Santo Antonio do Pinhal;2010;3854;2631;6485;59,43
3548302;Santo Expedito;2010;2476;325;2801;88,4
3548401;Santópolis do Aguapeí;2010;4129;144;4273;96,63
3548500;Santos;2010;419074;314;419388;99,93
3548609;São Bento do Sapucaí;2010;5040;5427;10467;48,15
3548708;São Bernardo do Campo;2010;752126;12796;764922;98,33
3548807;São Caetano do Sul;2010;149185;0;149185;100
3548906;São Carlos;2010;212813;8879;221692;95,99
3549003;São Francisco;2010;2168;626;2794;77,59
3549102;São João da Boa Vista;2010;80250;3335;83585;96,01
3549201;São João das Duas Pontes;2010;1962;605;2567;76,43
3549250;São João de Iracema;2010;1451;328;1779;81,56
3549300;São João do Pau d'Alho;2010;1706;398;2104;81,08
3549409;São Joaquim da Barra;2010;45636;833;46469;98,21
3549508;São José da Bela Vista;2010;7482;921;8403;89,04
3549607;São José do Barreiro;2010;2870;1208;4078;70,38
3549706;São José do Rio Pardo;2010;45946;5939;51885;88,55
3549805;São José do Rio Preto;2010;383075;24741;407816;93,93
3549904;São José dos Campos;2010;616308;12798;629106;97,97
3549953;São Lourenço da Serra;2010;12704;1253;13957;91,02
3550001;São Luís do Paraitinga;2010;6180;4217;10397;59,44
3550100;São Manuel;2010;37398;929;38327;97,58
3550209;São Miguel Arcanjo;2010;21499;9946;31445;68,37
3550308;São Paulo;2010;11144892;101091;11245983;99,1
3550407;São Pedro;2010;26579;5050;31629;84,03
3550506;São Pedro do Turvo;2010;5148;2047;7195;71,55
3550605;São Roque;2010;71388;7323;78711;90,7
3550704;São Sebastião;2010;72962;831;73793;98,87
3550803;São Sebastião da Grama;2010;7973;4129;12102;65,88
3550902;São Simão;2010;12923;1417;14340;90,12
3551009;São Vicente;2010;331565;628;332193;99,81
3551108;Sarapuí;2010;6638;2378;9016;73,62
3551207;Sarutaiá;2010;2958;665;3623;81,65
3551306;Sebastianópolis do Sul;2010;2344;683;3027;77,44
3551405;Serra Azul;2010;7989;3228;11217;71,22
3551504;Serrana;2010;38410;411;38821;98,94
3551603;Serra Negra;2010;22874;3491;26365;86,76
3551702;Sertãozinho;2010;108636;1300;109936;98,82
3551801;Sete Barras;2010;7194;5817;13011;55,29
3551900;Severínia;2010;14758;726;15484;95,31
3552007;Silveiras;2010;2877;2911;5788;49,71
3552106;Socorro;2010;24920;11731;36651;67,99
3552205;Sorocaba;2010;579819;5961;585780;98,98
3552304;Sud Mennucci;2010;6388;1046;7434;85,93
3552403;Sumaré;2010;238065;2836;240901;98,82
3552502;Suzano;2010;252950;9229;262179;96,48
3552551;Suzanópolis;2010;2255;1123;3378;66,76
3552601;Tabapuã;2010;10512;843;11355;92,58
3552700;Tabatinga;2010;12565;2106;14671;85,65
3552809;Taboão da Serra;2010;244095;0;244095;100
3552908;Taciba;2010;4849;861;5710;84,92
3553005;Taguaí;2010;7733;3062;10795;71,64
3553104;Taiaçu;2010;5337;555;5892;90,58
3553203;Taiúva;2010;4967;480;5447;91,19
3553302;Tambaú;2010;19908;2497;22405;88,86
3553401;Tanabi;2010;21723;2319;24042;90,35
3553500;Tapiraí;2010;5731;2285;8016;71,49
3553609;Tapiratiba;2010;10506;2233;12739;82,47
3553658;Taquaral;2010;2613;113;2726;95,85
3553708;Taquaritinga;2010;51153;2819;53972;94,78
3553807;Taquarituba;2010;19576;2712;22288;87,83
3553856;Taquarivaí;2010;2808;2337;5145;54,58
3553906;Tarabaí;2010;6103;497;6600;92,47
3553955;Tarumã;2010;12107;758;12865;94,11
3554003;Tatuí;2010;102138;5064;107202;95,28
3554102;Taubaté;2010;272373;6006;278379;97,84
3554201;Tejupá;2010;3123;1690;4813;64,89
3554300;Teodoro Sampaio;2010;17355;4019;21374;81,2
3554409;Terra Roxa;2010;8100;398;8498;95,32
3554508;Tietê;2010;33447;3342;36789;90,92
3554607;Timburi;2010;1925;722;2647;72,72
3554656;Torre de Pedra;2010;1468;785;2253;65,16
3554706;Torrinha;2010;7936;1390;9326;85,1
3554755;Trabiju;2010;1417;126;1543;91,83
3554805;Tremembé;2010;36886;4042;40928;90,12
3554904;Três Fronteiras;2010;4596;829;5425;84,72
3554953;Tuiuti;2010;2964;2957;5921;50,06
3555000;Tupã;2010;60929;2546;63475;95,99
3555109;Tupi Paulista;2010;11200;3061;14261;78,54
3555208;Turiúba;2010;1580;350;1930;81,87
3555307;Turmalina;2010;1409;572;1981;71,13
3555356;Ubarana;2010;4836;443;5279;91,61
3555406;Ubatuba;2010;76802;1891;78693;97,6
3555505;Ubirajara;2010;3228;1197;4425;72,95
3555604;Uchôa;2010;8797;670;9467;92,92
3555703;União Paulista;2010;1222;375;1597;76,52
3555802;Urânia;2010;7436;1400;8836;84,16
3555901;Uru;2010;1082;170;1252;86,42
3556008;Urupês;2010;11307;1399;12706;88,99
3556107;Valentim Gentil;2010;10052;961;11013;91,27
3556206;Valinhos;2010;101413;5156;106569;95,16
3556305;Valparaíso;2010;21434;1105;22539;95,1
3556354;Vargem;2010;4412;4372;8784;50,23
3556404;Vargem Grande do Sul;2010;37249;1991;39240;94,93
3556453;Vargem Grande Paulista;2010;42899;0;42899;100
3556503;Várzea Paulista;2010;106961;0;106961;100
3556602;Vera Cruz;2010;9366;1406;10772;86,95
3556701;Vinhedo;2010;61459;1994;63453;96,86
3556800;Viradouro;2010;16779;506;17285;97,07
3556909;Vista Alegre do Alto;2010;6333;532;6865;92,25
3556958;Vitória Brasil;2010;1434;302;1736;82,6
3557006;Votorantim;2010;104549;4146;108695;96,19
3557105;Votuporanga;2010;82241;2371;84612;97,2
3557154;Zacarias;2010;1833;498;2331;78,64
3557204;Chavantes;2010;11140;975;12115;91,95
3557303;Estiva Gerbi;2010;8002;2031;10033;79,76
3500105;Adamantina;2015;32398;1481;33879;95,63
3500204;Adolfo;2015;3205;296;3501;91,55
3500303;Aguaí;2015;30950;2959;33909;91,27
3500402;Águas da Prata;2015;6996;704;7700;90,86
3500501;Águas de Lindóia;2015;17691;160;17851;99,1
3500550;Águas de Santa Bárbara;2015;4437;1332;5769;76,91
3500600;Águas de São Pedro;2015;2928;0;2928;100
3500709;Agudos;2015;33955;1419;35374;95,99
3500758;Alambari;2015;4204;1137;5341;78,71
3500808;Alfredo Marcondes;2015;3429;487;3916;87,56
3500907;Altair;2015;3227;704;3931;82,09
3501004;Altinópolis;2015;13972;1590;15562;89,78
3501103;Alto Alegre;2015;3340;727;4067;82,12
3501152;Alumínio;2015;14606;2809;17415;83,87
3501202;Álvares Florence;2015;2660;1094;3754;70,86
3501301;Álvares Machado;2015;21412;2190;23602;90,72
3501400;Álvaro de Carvalho;2015;3171;1672;4843;65,48
3501509;Alvinlândia;2015;2819;274;3093;91,14
3501608;Americana;2015;222118;1042;223160;99,53
3501707;Américo Brasiliense;2015;37213;284;37497;99,24
3501806;Américo de Campos;2015;4926;805;5731;85,95
3501905;Amparo;2015;55435;12484;67919;81,62
3502002;Analândia;2015;3753;840;4593;81,71
3502101;Andradina;2015;52341;3434;55775;93,84
3502200;Angatuba;2015;17137;6225;23362;73,35
3502309;Anhembi;2015;4765;1407;6172;77,2
3502408;Anhumas;2015;3280;576;3856;85,06
3502507;Aparecida;2015;34849;514;35363;98,55
3502606;Aparecida d'Oeste;2015;3627;656;4283;84,68
3502705;Apiaí;2015;19022;5681;24703;77
3502754;Araçariguama;2015;19138;0;19138;100
3502804;Araçatuba;2015;182935;3598;186533;98,07
3502903;Araçoiaba da Serra;2015;20557;9350;29907;68,74
3503000;Aramina;2015;5083;257;5340;95,19
3503109;Arandu;2015;4860;1278;6138;79,18
3503158;Arapeí;2015;1890;582;2472;76,46
3503208;Araraquara;2015;213387;6244;219631;97,16
3503307;Araras;2015;118829;6356;125185;94,92
3503356;Arco-Íris;2015;1126;731;1857;60,64
3503406;Arealva;2015;6540;1487;8027;81,48
3503505;Areias;2015;2517;1237;3754;67,05
3503604;Areiópolis;2015;9720;964;10684;90,98
3503703;Ariranha;2015;8478;475;8953;94,69
3503802;Artur Nogueira;2015;44273;4626;48899;90,54
3503901;Arujá;2015;79273;3164;82437;96,16
3503950;Aspásia;2015;1292;494;1786;72,34
3504008;Assis;2015;94119;4296;98415;95,63
3504107;Atibaia;2015;123405;10037;133442;92,48
3504206;Auriflama;2015;13273;1093;14366;92,39
3504305;Avaí;2015;3442;1684;5126;67,15
3504404;Avanhandava;2015;9899;1808;11707;84,56
3504503;Avaré;2015;82107;3277;85384;96,16
3504602;Bady Bassitt;2015;14645;964;15609;93,82
3504701;Balbinos;2015;1187;2504;3691;32,16
3504800;Bálsamo;2015;7752;614;8366;92,66
3504909;Bananal;2015;8573;1850;10423;82,25
3505005;Barão de Antonina;2015;2032;1215;3247;62,58
3505104;Barbosa;2015;5898;1036;6934;85,06
3505203;Bariri;2015;31469;1403;32872;95,73
3505302;Barra Bonita;2015;34375;683;35058;98,05
3505351;Barra do Chapéu;2015;1584;3796;5380;29,44
3505401;Barra do Turvo;2015;3362;4297;7659;43,9
3505500;Barretos;2015;111863;3515;115378;96,95
3505609;Barrinha;2015;30125;338;30463;98,89
3505708;Barueri;2015;253047;0;253047;100
3505807;Bastos;2015;17724;2535;20259;87,49
3505906;Batatais;2015;51713;6762;58475;88,44
3506003;Bauru;2015;348991;5937;354928;98,33
3506102;Bebedouro;2015;71568;3135;74703;95,8
3506201;Bento de Abreu;2015;2645;169;2814;93,99
3506300;Bernardino de Campos;2015;9763;1007;10770;90,65
3506359;Bertioga;2015;54972;688;55660;98,76
3506409;Bilac;2015;6967;502;7469;93,28
3506508;Birigui;2015;112268;3227;115495;97,21
3506607;Biritiba Mirim;2015;26358;4097;30455;86,55
3506706;Boa Esperança do Sul;2015;12811;1309;14120;90,73
3506805;Bocaina;2015;10701;826;11527;92,83
3506904;Bofete;2015;6615;3761;10376;63,75
3507001;Boituva;2015;50071;3157;53228;94,07
3507100;Bom Jesus dos Perdões;2015;19849;2274;22123;89,72
3507159;Bom Sucesso de Itararé;2015;2648;1055;3703;71,51
3507209;Borá;2015;629;179;808;77,85
3507308;Boracéia;2015;4091;430;4521;90,49
3507407;Borborema;2015;13843;1133;14976;92,43
3507456;Borebi;2015;2215;229;2444;90,63
3507506;Botucatu;2015;130137;4721;134858;96,5
3507605;Bragança Paulista;2015;152793;3448;156241;97,79
3507704;Braúna;2015;4801;503;5304;90,52
3507753;Brejo Alegre;2015;2250;427;2677;84,05
3507803;Brodowski;2015;22292;388;22680;98,29
3507902;Brotas;2015;19734;3062;22796;86,57
3508009;Buri;2015;15678;3381;19059;82,26
3508108;Buritama;2015;15282;771;16053;95,2
3508207;Buritizal;2015;3465;723;4188;82,74
3508306;Cabrália Paulista;2015;3756;566;4322;86,9
3508405;Cabreúva;2015;39820;5736;45556;87,41
3508504;Caçapava;2015;75592;12754;88346;85,56
3508603;Cachoeira Paulista;2015;25789;5436;31225;82,59
3508702;Caconde;2015;13084;5601;18685;70,02
3508801;Cafelândia;2015;15004;1935;16939;88,58
3508900;Caiabu;2015;3420;674;4094;83,54
3509007;Caieiras;2015;91719;1920;93639;97,95
3509106;Caiuá;2015;2042;3287;5329;38,32
3509205;Cajamar;2015;69980;1033;71013;98,55
3509254;Cajati;2015;20978;7525;28503;73,6
3509304;Cajobi;2015;9392;566;9958;94,32
3509403;Cajuru;2015;21882;2655;24537;89,18
3509452;Campina do Monte Alegre;2015;4919;771;5690;86,45
3509502;Campinas;2015;1115037;19509;1134546;98,28
3509601;Campo Limpo Paulista;2015;78619;0;78619;100
3509700;Campos do Jordão;2015;48691;306;48997;99,38
3509809;Campos Novos Paulista;2015;3758;919;4677;80,35
3509908;Cananéia;2015;10522;1689;12211;86,17
3509957;Canas;2015;4492;241;4733;94,91
3510005;Cândido Mota;2015;28374;1591;29965;94,69
3510104;Cândido Rodrigues;2015;2227;448;2675;83,25
3510153;Canitar;2015;4457;217;4674;95,36
3510203;Capão Bonito;2015;38531;7602;46133;83,52
3510302;Capela do Alto;2015;16135;2871;19006;84,89
3510401;Capivari;2015;49709;1738;51447;96,62
3510500;Caraguatatuba;2015;104734;4264;108998;96,09
3510609;Carapicuíba;2015;383226;0;383226;100
3510708;Cardoso;2015;10767;1001;11768;91,49
3510807;Casa Branca;2015;23793;5110;28903;82,32
3510906;Cássia dos Coqueiros;2015;1856;697;2553;72,7
3511003;Castilho;2015;14649;4763;19412;75,46
3511102;Catanduva;2015;114362;926;115288;99,2
3511201;Catiguá;2015;6812;534;7346;92,73
3511300;Cedral;2015;6842;1592;8434;81,12
3511409;Cerqueira César;2015;16740;1651;18391;91,02
3511508;Cerquilho;2015;41112;2243;43355;94,83
3511607;Cesário Lange;2015;11151;5365;16516;67,52
3511706;Charqueada;2015;14617;1426;16043;91,11
3511904;Clementina;2015;7454;289;7743;96,27
3512001;Colina;2015;16559;956;17515;94,54
3512100;Colômbia;2015;4442;1583;6025;73,73
3512209;Conchal;2015;25190;1098;26288;95,82
3512308;Conchas;2015;13928;2789;16717;83,32
3512407;Cordeirópolis;2015;20500;2324;22824;89,82
3512506;Coroados;2015;4694;926;5620;83,52
3512605;Coronel Macedo;2015;3902;993;4895;79,71
3512704;Corumbataí;2015;2286;1633;3919;58,33
3512803;Cosmópolis;2015;60672;4656;65328;92,87
3512902;Cosmorama;2015;5175;1925;7100;72,89
3513009;Cotia;2015;224980;0;224980;100
3513108;Cravinhos;2015;32481;632;33113;98,09
3513207;Cristais Paulista;2015;6294;1738;8032;78,36
3513306;Cruzália;2015;1506;680;2186;68,89
3513405;Cruzeiro;2015;76709;1872;78581;97,62
3513504;Cubatão;2015;124043;0;124043;100
3513603;Cunha;2015;12858;8839;21697;59,26
3513702;Descalvado;2015;28999;2798;31797;91,2
3513801;Diadema;2015;396234;0;396234;100
3513850;Dirce Reis;2015;1357;351;1708;79,45
3513900;Divinolândia;2015;7855;3165;11020;71,28
3514007;Dobrada;2015;8240;188;8428;97,77
3514106;Dois Córregos;2015;24829;1041;25870;95,98
3514205;Dolcinópolis;2015;1938;131;2069;93,67
3514304;Dourado;2015;7819;721;8540;91,56
3514403;Dracena;2015;40984;3263;44247;92,63
3514502;Duartina;2015;11037;1079;12116;91,09
3514601;Dumont;2015;8731;229;8960;97,44
3514700;Echaporã;2015;5089;1173;6262;81,27
3514809;Eldorado;2015;7297;7531;14828;49,21
3514908;Elias Fausto;2015;13628;2984;16612;82,04
3514924;Elisiário;2015;3084;240;3324;92,78
3514957;Embaúba;2015;2096;312;2408;87,04
3515004;Embu;2015;256031;0;256031;100
3515103;Embu-Guaçu;2015;63690;1745;65435;97,33
3515129;Emilianópolis;2015;2609;445;3054;85,43
3515152;Engenheiro Coelho;2015;13699;4644;18343;74,68
3515186;Espírito Santo do Pinhal;2015;38118;4176;42294;90,13
3515194;Espírito Santo do Turvo;2015;3865;654;4519;85,53
3515202;Estrela d'Oeste;2015;6968;1189;8157;85,42
3515301;Estrela do Norte;2015;2207;447;2654;83,16
3515350;Euclides da Cunha Paulista;2015;6094;3406;9500;64,15
3515400;Fartura;2015;12632;2829;15461;81,7
3515509;Fernandópolis;2015;63544;2008;65552;96,94
3515608;Fernando Prestes;2015;4898;663;5561;88,08
3515657;Fernão;2015;928;676;1604;57,86
3515707;Ferraz de Vasconcelos;2015;172664;8111;180775;95,51
3515806;Flora Rica;2015;1396;258;1654;84,4
3515905;Floreal;2015;2432;494;2926;83,12
3516002;Flórida Paulista;2015;9821;2626;12447;78,9
3516101;Florínia;2015;2485;265;2750;90,36
3516200;Franca;2015;325443;5816;331259;98,24
3516309;Francisco Morato;2015;163725;333;164058;99,8
3516408;Franco da Rocha;2015;131019;11195;142214;92,13
3516507;Gabriel Monteiro;2015;2335;367;2702;86,42
3516606;Gália;2015;5120;1610;6730;76,08
3516705;Garça;2015;39609;3160;42769;92,61
3516804;Gastão Vidigal;2015;4153;360;4513;92,02
3516853;Gavião Peixoto;2015;3872;644;4516;85,74
3516903;General Salgado;2015;9290;1396;10686;86,94
3517000;Getulina;2015;8589;2208;10797;79,55
3517109;Glicério;2015;3516;1148;4664;75,39
3517208;Guaiçara;2015;10440;894;11334;92,11
3517307;Guaimbê;2015;4889;577;5466;89,44
3517406;Guaíra;2015;37079;1248;38327;96,74
3517505;Guapiaçu;2015;17505;1984;19489;89,82
3517604;Guapiara;2015;7286;10404;17690;41,19
3517703;Guará;2015;19772;550;20322;97,29
3517802;Guaraçai;2015;6801;1639;8440;80,58
3517901;Guaraci;2015;9597;897;10494;91,45
3518008;Guarani d'Oeste;2015;1728;219;1947;88,75
3518107;Guarantã;2015;5689;747;6436;88,39
3518206;Guararapes;2015;29351;2094;31445;93,34
3518305;Guararema;2015;23769;3852;27621;86,05
3518404;Guaratinguetá;2015;110040;5406;115446;95,32
3518503;Guareí;2015;8758;6405;15163;57,76
3518602;Guariba;2015;36676;675;37351;98,19
3518701;Guarujá;2015;303318;58;303376;99,98
3518800;Guarulhos;2015;1288364;0;1288364;100
3518859;Guatapará;2015;5555;1649;7204;77,11
3518909;Guzolândia;2015;4296;640;4936;87,03
3519006;Herculândia;2015;8318;662;8980;92,63
3519055;Holambra;2015;10364;2696;13060;79,36
3519071;Hortolândia;2015;211690;0;211690;100
3519105;Iacanga;2015;9411;1291;10702;87,94
3519204;Iacri;2015;5199;1154;6353;81,84
3519253;Iaras;2015;2947;3677;6624;44,49
3519303;Ibaté;2015;31616;1200;32816;96,34
3519402;Ibirá;2015;10716;805;11521;93,01
3519501;Ibirarema;2015;6643;478;7121;93,29
3519600;Ibitinga;2015;54092;1965;56057;96,49
3519709;Ibiúna;2015;26549;47308;73857;35,95
3519808;Icém;2015;6694;1066;7760;86,26
3519907;Iepê;2015;7075;693;7768;91,08
3520004;Igaraçu do Tietê;2015;23603;136;23739;99,43
3520103;Igarapava;2015;27304;1457;28761;94,93
3520202;Igaratá;2015;7507;1568;9075;82,72
3520301;Iguape;2015;25272;3810;29082;86,9
3520400;Ilhabela;2015;30822;214;31036;99,31
3520426;Ilha Comprida;2015;9647;0;9647;100
3520442;Ilha Solteira;2015;23917;1570;25487;93,84
3520509;Indaiatuba;2015;223702;2272;225974;98,99
3520608;Indiana;2015;4173;628;4801;86,92
3520707;Indiaporã;2015;3441;428;3869;88,94
3520806;Inúbia Paulista;2015;3362;407;3769;89,2
3520905;Ipaussu;2015;13133;945;14078;93,29
3521002;Iperó;2015;19456;12075;31531;61,7
3521101;Ipeúna;2015;6006;775;6781;88,57
3521150;Ipiguá;2015;3048;1822;4870;62,59
3521200;Iporanga;2015;2641;1698;4339;60,87
3521309;Ipuã;2015;14494;542;15036;96,4
3521408;Iracemápolis;2015;21609;403;22012;98,17
3521507;Irapuã;2015;6846;671;7517;91,07
3521606;Irapuru;2015;5333;2211;7544;70,69
3521705;Itaberá;2015;12755;4923;17678;72,15
3521804;Itaí;2015;19835;5425;25260;78,52
3521903;Itajobi;2015;12560;2060;14620;85,91
3522000;Itaju;2015;2673;792;3465;77,14
3522109;Itanhaém;2015;92179;777;92956;99,16
3522158;Itaóca;2015;1737;1449;3186;54,52
3522208;Itapecerica da Serra;2015;159934;1337;161271;99,17
3522307;Itapetininga;2015;139261;13068;152329;91,42
3522406;Itapeva;2015;78882;10690;89572;88,07
3522505;Itapevi;2015;218853;0;218853;100
3522604;Itapira;2015;65611;4730;70341;93,28
3522653;Itapirapuã Paulista;2015;2005;2001;4006;50,05
3522703;Itápolis;2015;37765;3072;40837;92,48
3522802;Itaporanga;2015;11497;3103;14600;78,75
3522901;Itapuí;2015;12547;466;13013;96,42
3523008;Itapura;2015;3708;932;4640;79,91
3523107;Itaquaquecetuba;2015;345787;0;345787;100
3523206;Itararé;2015;44774;3603;48377;92,55
3523305;Itariri;2015;11097;5263;16360;67,83
3523404;Itatiba;2015;94736;15628;110364;85,84
3523503;Itatinga;2015;17791;1490;19281;92,27
3523602;Itirapina;2015;14967;1403;16370;91,43
3523701;Itirapuã;2015;5177;917;6094;84,95
3523800;Itobi;2015;7001;577;7578;92,39
3523909;Itu;2015;153218;9091;162309;94,4
3524006;Itupeva;2015;47419;4815;52234;90,78
3524105;Ituverava;2015;37235;2315;39550;94,15
3524204;Jaborandi;2015;6268;376;6644;94,34
3524303;Jaboticabal;2015;71445;1646;73091;97,75
3524402;Jacareí;2015;217063;3040;220103;98,62
3524501;Jaci;2015;5675;669;6344;89,45
3524600;Jacupiranga;2015;9340;7815;17155;54,44
3524709;Jaguariúna;2015;49338;1048;50386;97,92
3524808;Jales;2015;44388;2782;47170;94,1
3524907;Jambeiro;2015;2798;3046;5844;47,88
3525003;Jandira;2015;116045;0;116045;100
3525102;Jardinópolis;2015;39373;1120;40493;97,23
3525201;Jarinu;2015;22163;4798;26961;82,2
3525300;Jaú;2015;136018;3826;139844;97,26
3525409;Jeriquara;2015;2673;475;3148;84,91
3525508;Joanópolis;2015;12255;0;12255;100
3525607;João Ramalho;2015;3728;539;4267;87,37
3525706;José Bonifácio;2015;31535;2884;34419;91,62
3525805;Júlio Mesquita;2015;4315;209;4524;95,38
3525854;Jumirim;2015;1906;1169;3075;61,98
3525904;Jundiaí;2015;377413;13627;391040;96,52
3526001;Junqueirópolis;2015;16241;3161;19402;83,71
3526100;Juquiá;2015;12150;6762;18912;64,24
3526209;Juquitiba;2015;24199;5309;29508;82,01
3526308;Lagoinha;2015;3276;1542;4818;68
3526407;Laranjal Paulista;2015;23945;2640;26585;90,07
3526506;Lavínia;2015;4205;4411;8616;48,8
3526605;Lavrinhas;2015;6404;478;6882;93,05
3526704;Leme;2015;94726;1803;96529;98,13
3526803;Lençóis Paulista;2015;62788;1222;64010;98,09
3526902;Limeira;2015;279414;7468;286882;97,4
3527009;Lindóia;2015;7285;0;7285;100
3527108;Lins;2015;72625;859;73484;98,83
3527207;Lorena;2015;82437;2216;84653;97,38
3527256;Lourdes;2015;1816;347;2163;83,96
3527306;Louveira;2015;42064;1258;43322;97,1
3527405;Lucélia;2015;17834;2657;20491;87,03
3527504;Lucianópolis;2015;1807;442;2249;80,35
3527603;Luís Antônio;2015;12637;284;12921;97,8
3527702;Luiziânia;2015;5035;360;5395;93,33
3527801;Lupércio;2015;4100;286;4386;93,48
3527900;Lutécia;2015;2176;484;2660;81,8
3528007;Macatuba;2015;16191;416;16607;97,5
3528106;Macaubal;2015;6935;798;7733;89,68
3528205;Macedônia;2015;2813;804;3617;77,77
3528304;Magda;2015;2651;493;3144;84,32
3528403;Mairinque;2015;36004;8856;44860;80,26
3528502;Mairiporã;2015;81154;8949;90103;90,07
3528601;Manduri;2015;8330;950;9280;89,76
3528700;Marabá Paulista;2015;2166;2701;4867;44,5
3528809;Maracaí;2015;12320;1121;13441;91,66
3528858;Marapoama;2015;2434;347;2781;87,52
3528908;Mariápolis;2015;3281;667;3948;83,11
3529005;Marília;2015;214559;10078;224637;95,51
3529104;Marinópolis;2015;1698;403;2101;80,82
3529203;Martinópolis;2015;21348;3613;24961;85,53
3529302;Matão;2015;77168;1442;78610;98,17
3529401;Mauá;2015;439947;0;439947;100
3529500;Mendonça;2015;4119;745;4864;84,68
3529609;Meridiano;2015;2694;1104;3798;70,93
3529658;Mesópolis;2015;1563;324;1887;82,83
3529708;Miguelópolis;2015;19904;1068;20972;94,91
3529807;Mineiros do Tietê;2015;11771;551;12322;95,53
3529906;Miracatu;2015;10558;9469;20027;52,72
3530003;Mira Estrela;2015;1922;960;2882;66,69
3530102;Mirandópolis;2015;25381;2747;28128;90,23
3530201;Mirante do Paranapanema;2015;10265;7167;17432;58,89
3530300;Mirassol;2015;54526;1413;55939;97,47
3530409;Mirassolândia;2015;3659;842;4501;81,29
3530508;Mococa;2015;62410;4098;66508;93,84
3530607;Mogi das Cruzes;2015;379774;31000;410774;92,45
3530706;Mogi-Guaçu;2015;136604;6466;143070;95,48
3530805;Moji Mirim;2015;84096;4599;88695;94,81
3530904;Mombuca;2015;2828;473;3301;85,67
3531001;Monções;2015;1873;287;2160;86,71
3531100;Mongaguá;2015;50382;221;50603;99,56
3531209;Monte Alegre do Sul;2015;4474;3010;7484;59,78
3531308;Monte Alto;2015;45882;1782;47664;96,26
3531407;Monte Aprazível;2015;20990;1783;22773;92,17
3531506;Monte Azul Paulista;2015;17559;995;18554;94,64
3531605;Monte Castelo;2015;3271;746;4017;81,43
3531704;Monteiro Lobato;2015;1882;2416;4298;43,79
3531803;Monte Mor;2015;51467;2821;54288;94,8
3531902;Morro Agudo;2015;29844;922;30766;97
3532009;Morungaba;2015;11030;1505;12535;87,99
3532058;Motuca;2015;3414;1055;4469;76,39
3532108;Murutinga do Sul;2015;2606;1633;4239;61,48
3532157;Nantes;2015;2710;186;2896;93,58
3532207;Narandiba;2015;3521;1040;4561;77,2
3532306;Natividade da Serra;2015;2812;3867;6679;42,1
3532405;Nazaré Paulista;2015;16283;1169;17452;93,3
3532504;Neves Paulista;2015;7955;761;8716;91,27
3532603;Nhandeara;2015;8915;1880;10795;82,58
3532702;Nipoã;2015;4190;470;4660;89,91
3532801;Nova Aliança;2015;5279;905;6184;85,37
3532827;Nova Campina;2015;6700;2364;9064;73,92
3532843;Nova Canaã Paulista;2015;931;1089;2020;46,09
3532868;Nova Castilho;2015;851;304;1155;73,68
3532900;Nova Europa;2015;9446;602;10048;94,01
3533007;Nova Granada;2015;18743;1336;20079;93,35
3533106;Nova Guataporanga;2015;1934;252;2186;88,47
3533205;Nova Independência;2015;2831;598;3429;82,56
3533254;Novais;2015;4713;381;5094;92,52
3533304;Nova Lusitânia;2015;3471;307;3778;91,87
3533403;Nova Odessa;2015;54016;895;54911;98,37
3533502;Novo Horizonte;2015;35400;2438;37838;93,56
3533601;Nuporanga;2015;6599;458;7057;93,51
3533700;Ocauçu;2015;3466;685;4151;83,5
3533809;Óleo;2015;1784;799;2583;69,07
3533908;Olímpia;2015;48821;2550;51371;95,04
3534005;Onda Verde;2015;3335;725;4060;82,14
3534104;Oriente;2015;5844;337;6181;94,55
3534203;Orindiúva;2015;5861;453;6314;92,83
3534302;Orlândia;2015;40054;1059;41113;97,42
3534401;Osasco;2015;672958;0;672958;100
3534500;Oscar Bressane;2015;2156;368;2524;85,42
3534609;Osvaldo Cruz;2015;28208;2926;31134;90,6
3534708;Ourinhos;2015;104148;2761;106909;97,42
3534757;Ouroeste;2015;8418;716;9134;92,16
3534807;Ouro Verde;2015;7489;548;8037;93,18
3534906;Pacaembu;2015;9681;3458;13139;73,68
3535002;Palestina;2015;9881;1789;11670;84,67
3535101;Palmares Paulista;2015;11668;346;12014;97,12
3535200;Palmeira d'Oeste;2015;7339;1974;9313;78,8
3535309;Palmital;2015;20044;1364;21408;93,63
3535408;Panorama;2015;14545;352;14897;97,64
3535507;Paraguaçu Paulista;2015;39207;4057;43264;90,62
3535606;Paraibuna;2015;5369;12440;17809;30,15
3535705;Paraíso;2015;5478;625;6103;89,76
3535804;Paranapanema;2015;15821;3049;18870;83,84
3535903;Paranapuã;2015;3496;364;3860;90,57
3536000;Parapuã;2015;8984;1678;10662;84,26
3536109;Pardinho;2015;5041;944;5985;84,23
3536208;Pariquera-Açu;2015;13143;5716;18859;69,69
3536257;Parisi;2015;1687;361;2048;82,37
3536307;Patrocínio Paulista;2015;11420;2330;13750;83,05
3536406;Paulicéia;2015;5842;915;6757;86,46
3536505;Paulínia;2015;94945;88;95033;99,91
3536570;Paulistânia;2015;1303;474;1777;73,33
3536604;Paulo de Faria;2015;7774;764;8538;91,05
3536703;Pederneiras;2015;40555;3053;43608;93
3536802;Pedra Bela;2015;1573;4306;5879;26,76
3536901;Pedranópolis;2015;1563;915;2478;63,08
3537008;Pedregulho;2015;11886;4116;16002;74,28
3537107;Pedreira;2015;43887;372;44259;99,16
3537156;Pedrinhas Paulista;2015;2554;423;2977;85,79
3537206;Pedro de Toledo;2015;7383;3191;10574;69,82
3537305;Penápolis;2015;57551;2198;59749;96,32
3537404;Pereira Barreto;2015;23527;1672;25199;93,36
3537503;Pereiras;2015;5319;2646;7965;66,78
3537602;Peruíbe;2015;62460;517;62977;99,18
3537701;Piacatu;2015;5058;541;5599;90,34
3537800;Piedade;2015;24464;28312;52776;46,35
3537909;Pilar do Sul;2015;22156;5189;27345;81,02
3538006;Pindamonhangaba;2015;151159;4798;155957;96,92
3538105;Pindorama;2015;14901;842;15743;94,65
3538204;Pinhalzinho;2015;6955;7009;13964;49,81
3538303;Piquerobi;2015;2744;789;3533;77,67
3538501;Piquete;2015;12961;865;13826;93,74
3538600;Piracaia;2015;25693;0;25693;100
3538709;Piracicaba;2015;370911;7274;378185;98,08
3538808;Piraju;2015;26021;2545;28566;91,09
3538907;Pirajuí;2015;18894;4217;23111;81,75
3539004;Pirangi;2015;9768;976;10744;90,92
3539103;Pirapora do Bom Jesus;2015;17236;0;17236;100
3539202;Pirapozinho;2015;24804;1167;25971;95,51
3539301;Pirassununga;2015;66790;5232;72022;92,74
3539400;Piratininga;2015;10970;1684;12654;86,69
3539509;Pitangueiras;2015;35832;1148;36980;96,9
3539608;Planalto;2015;4197;635;4832;86,86
3539707;Platina;2015;2704;643;3347;80,79
3539806;Poá;2015;109290;1755;111045;98,42
3539905;Poloni;2015;4928;609;5537;89
3540002;Pompéia;2015;19293;1357;20650;93,43
3540101;Pongaí;2015;2924;469;3393;86,18
3540200;Pontal;2015;44711;616;45327;98,64
3540259;Pontalinda;2015;3675;620;4295;85,56
3540309;Pontes Gestal;2015;2192;328;2520;86,98
3540408;Populina;2015;3379;721;4100;82,41
3540507;Porangaba;2015;4273;4576;8849;48,29
3540606;Porto Feliz;2015;43109;7230;50339;85,64
3540705;Porto Ferreira;2015;51925;948;52873;98,21
3540754;Potim;2015;15198;4844;20042;75,83
3540804;Potirendaba;2015;14665;1427;16092;91,13
3540853;Pracinha;2015;1378;1499;2877;47,9
3540903;Pradópolis;2015;17941;1356;19297;92,97
3541000;Praia Grande;2015;290918;0;290918;100
3541059;Pratânia;2015;3837;1033;4870;78,79
3541109;Presidente Alves;2015;3483;577;4060;85,79
3541208;Presidente Bernardes;2015;11036;2631;13667;80,75
3541307;Presidente Epitácio;2015;39173;2662;41835;93,64
3541406;Presidente Prudente;2015;210423;4382;214805;97,96
3541505;Presidente Venceslau;2015;36662;1332;37994;96,49
3541604;Promissão;2015;32114;5597;37711;85,16
3541653;Quadra;2015;896;2586;3482;25,73
3541703;Quatá;2015;12651;728;13379;94,56
3541802;Queiroz;2015;2672;372;3044;87,78
3541901;Queluz;2015;9884;2167;12051;82,02
3542008;Quitana;2015;5759;501;6260;92
3542107;Rafard;2015;7821;949;8770;89,18
3542206;Rancharia;2015;26155;2644;28799;90,82
3542305;Redenção da Serra;2015;2506;1341;3847;65,14
3542404;Regente Feijó;2015;17705;1309;19014;93,12
3542503;Reginópolis;2015;4323;2935;7258;59,56
3542602;Registro;2015;47944;6064;54008;88,77
3542701;Restinga;2015;5675;1366;7041;80,6
3542800;Ribeira;2015;1351;1928;3279;41,2
3542909;Ribeirão Bonito;2015;11754;788;12542;93,72
3543006;Ribeirão Branco;2015;9787;7961;17748;55,14
3543105;Ribeirão Corrente;2015;3632;841;4473;81,2
3543204;Ribeirão do Sul;2015;3439;950;4389;78,35
3543238;Ribeirão dos Índios;2015;1874;286;2160;86,76
3543253;Ribeirão Grande;2015;2362;5104;7466;31,64
3543303;Ribeirão Pires;2015;116358;0;116358;100
3543402;Ribeirão Preto;2015;646023;1839;647862;99,72
3543501;Riversul;2015;4373;1520;5893;74,21
3543600;Rifaina;2015;3042;408;3450;88,17
3543709;Rincão;2015;8551;1895;10446;81,86
3543808;Rinópolis;2015;8805;1008;9813;89,73
3543907;Rio Claro;2015;189633;4454;194087;97,71
3544004;Rio das Pedras;2015;31345;809;32154;97,48
3544103;Rio Grande da Serra;2015;46949;0;46949;100
3544202;Riolândia;2015;8703;2298;11001;79,11
3544251;Rosana;2015;17464;1430;18894;92,43
3544301;Roseira;2015;9689;453;10142;95,53
3544400;Rubiácea;2015;1722;1208;2930;58,77
3544509;Rubinéia;2015;2505;429;2934;85,38
3544608;Sabino;2015;4800;554;5354;89,65
3544707;Sagres;2015;1904;462;2366;80,47
3544806;Sales;2015;5326;458;5784;92,08
3544905;Sales Oliveira;2015;10268;815;11083;92,65
3545001;Salesópolis;2015;10550;5676;16226;65,02
3545100;Salmourão;2015;4579;381;4960;92,32
3545159;Saltinho;2015;6290;1227;7517;83,68
3545209;Salto;2015;109765;777;110542;99,3
3545308;Salto de Pirapora;2015;33208;9065;42273;78,56
3545407;Salto Grande;2015;8154;776;8930;91,31
3545506;Sandovalina;2015;2983;977;3960;75,33
3545605;Santa Adélia;2015;13842;789;14631;94,61
3545704;Santa Albertina;2015;4994;710;5704;87,55
3545803;Santa Bárbara d'Oeste;2015;183232;1450;184682;99,21
3546009;Santa Branca;2015;12331;1648;13979;88,21
3546108;Santa Clara d'Oeste;2015;1603;450;2053;78,08
3546207;Santa Cruz da Conceição;2015;3062;1118;4180;73,25
3546256;Santa Cruz da Esperança;2015;1378;640;2018;68,29
3546306;Santa Cruz das Palmeiras;2015;31104;801;31905;97,49
3546405;Santa Cruz do Rio Pardo;2015;41821;3198;45019;92,9
3546504;Santa Ernestina;2015;5265;276;5541;95,02
3546603;Santa Fé do Sul;2015;28873;1183;30056;96,06
3546702;Santa Gertrudes;2015;23688;255;23943;98,93
3546801;Santa Isabel;2015;42225;10650;52875;79,86
3546900;Santa Lucia;2015;8006;409;8415;95,14
3547007;Santa Maria da Serra;2015;5175;599;5774;89,63
3547106;Santa Mercedes;2015;2518;298;2816;89,42
3547205;Santana da Ponte Pensa;2015;1106;460;1566;70,63
3547304;Santana de Parnaíba;2015;124050;0;124050;100
3547403;Santa Rita d'Oeste;2015;1848;627;2475;74,67
3547502;Santa Rita do Passa Quatro;2015;24021;2421;26442;90,84
3547601;Santa Rosa do Viterbo;2015;23723;1041;24764;95,8
3547650;Santa Salete;2015;935;512;1447;64,62
3547700;Santo Anastácio;2015;18995;1262;20257;93,77
3547809;Santo André;2015;685606;0;685606;100
3547908;Santo Antonio da Alegria;2015;4838;1639;6477;74,7
3548005;Santo Antonio da Posse;2015;20469;1331;21800;93,89
3548054;Santo Antonio do Aracanguá;2015;6618;1344;7962;83,12
3548104;Santo Antonio do Jardim;2015;3662;2204;5866;62,43
3548203;Santo Antonio do Pinhal;2015;4247;2302;6549;64,85
3548302;Santo Expedito;2015;2639;252;2891;91,28
3548401;Santópolis do Aguapeí;2015;4358;124;4482;97,23
3548500;Santos;2015;423262;317;423579;99,93
3548609;São Bento do Sapucaí;2015;5228;5253;10481;49,88
3548708;São Bernardo do Campo;2015;778481;12978;791459;98,36
3548807;São Caetano do Sul;2015;150605;0;150605;100
3548906;São Carlos;2015;223907;9342;233249;95,99
3549003;São Francisco;2015;2188;547;2735;80
3549102;São João da Boa Vista;2015;82990;2705;85695;96,84
3549201;São João das Duas Pontes;2015;1932;585;2517;76,76
3549250;São João de Iracema;2015;1564;256;1820;85,93
3549300;São João do Pau d'Alho;2015;1711;326;2037;84
3549409;São Joaquim da Barra;2015;47669;861;48530;98,23
3549508;São José da Bela Vista;2015;7717;838;8555;90,2
3549607;São José do Barreiro;2015;3051;1017;4068;75
3549706;São José do Rio Pardo;2015;47627;4968;52595;90,55
3549805;São José do Rio Preto;2015;404206;26106;430312;93,93
3549904;São José dos Campos;2015;658874;13682;672556;97,97
3549953;São Lourenço da Serra;2015;13595;1164;14759;92,11
3550001;São Luís do Paraitinga;2015;6252;4221;10473;59,7
3550100;São Manuel;2015;38296;661;38957;98,3
3550209;São Miguel Arcanjo;2015;23068;8613;31681;72,81
3550308;São Paulo;2015;11477688;104110;11581798;99,1
3550407;São Pedro;2015;28261;4752;33013;85,61
3550506;São Pedro do Turvo;2015;5443;1825;7268;74,89
3550605;São Roque;2015;78992;4518;83510;94,59
3550704;São Sebastião;2015;79950;911;80861;98,87
3550803;São Sebastião da Grama;2015;8212;3764;11976;68,57
3550902;São Simão;2015;13316;1270;14586;91,29
3551009;São Vicente;2015;344579;652;345231;99,81
3551108;Sarapuí;2015;7388;2181;9569;77,21
3551207;Sarutaiá;2015;3054;575;3629;84,16
3551306;Sebastianópolis do Sul;2015;2610;576;3186;81,92
3551405;Serra Azul;2015;8378;3384;11762;71,23
3551504;Serrana;2015;41464;314;41778;99,25
3551603;Serra Negra;2015;23453;3528;26981;86,92
3551702;Sertãozinho;2015;116013;819;116832;99,3
3551801;Sete Barras;2015;8225;4468;12693;64,8
3551900;Severínia;2015;15718;620;16338;96,21
3552007;Silveiras;2015;3105;2893;5998;51,77
3552106;Socorro;2015;26428;11423;37851;69,82
3552205;Sorocaba;2015;617391;6348;623739;98,98
3552304;Sud Mennucci;2015;6530;1060;7590;86,03
3552403;Sumaré;2015;260378;3102;263480;98,82
3552502;Suzano;2015;267106;9746;276852;96,48
3552551;Suzanópolis;2015;2462;1226;3688;66,76
3552601;Tabapuã;2015;10898;772;11670;93,38
3552700;Tabatinga;2015;13511;1796;15307;88,27
3552809;Taboão da Serra;2015;264574;0;264574;100
3552908;Taciba;2015;5091;796;5887;86,48
3553005;Taguaí;2015;8696;3443;12139;71,64
3553104;Taiaçu;2015;5495;473;5968;92,07
3553203;Taiúva;2015;5891;461;6352;92,74
3553302;Tambaú;2015;20362;2213;22575;90,2
3553401;Tanabi;2015;22742;1919;24661;92,22
3553500;Tapiraí;2015;5709;2073;7782;73,36
3553609;Tapiratiba;2015;10943;1709;12652;86,49
3553658;Taquaral;2015;2630;101;2731;96,3
3553708;Taquaritinga;2015;51839;2364;54203;95,64
3553807;Taquarituba;2015;20418;2366;22784;89,62
3553856;Taquarivaí;2015;3064;2376;5440;56,32
3553906;Tarabaí;2015;6475;465;6940;93,3
3553955;Tarumã;2015;13160;718;13878;94,83
3554003;Tatuí;2015;109684;4130;113814;96,37
3554102;Taubaté;2015;287742;6040;293782;97,94
3554201;Tejupá;2015;3354;1367;4721;71,04
3554300;Teodoro Sampaio;2015;17973;3957;21930;81,96
3554409;Terra Roxa;2015;8456;364;8820;95,87
3554508;Tietê;2015;35575;3456;39031;91,15
3554607;Timburi;2015;1960;635;2595;75,53
3554656;Torre de Pedra;2015;1560;726;2286;68,24
3554706;Torrinha;2015;8211;1309;9520;86,25
3554755;Trabiju;2015;1505;116;1621;92,84
3554805;Tremembé;2015;40116;3620;43736;91,72
3554904;Três Fronteiras;2015;4768;724;5492;86,82
3554953;Tuiuti;2015;3271;2997;6268;52,19
3555000;Tupã;2015;60580;2531;63111;95,99
3555109;Tupi Paulista;2015;11594;3168;14762;78,54
3555208;Turiúba;2015;1604;322;1926;83,28
3555307;Turmalina;2015;1389;496;1885;73,69
3555356;Ubarana;2015;5240;451;5691;92,08
3555406;Ubatuba;2015;81905;1985;83890;97,63
3555505;Ubirajara;2015;3335;1212;4547;73,35
3555604;Uchôa;2015;8970;618;9588;93,55
3555703;União Paulista;2015;1314;358;1672;78,59
3555802;Urânia;2015;7492;1243;8735;85,77
3555901;Uru;2015;1112;111;1223;90,92
3556008;Urupês;2015;11752;1204;12956;90,71
3556107;Valentim Gentil;2015;11019;926;11945;92,25
3556206;Valinhos;2015;112138;5402;117540;95,4
3556305;Valparaíso;2015;22510;792;23302;96,6
3556354;Vargem;2015;5339;4078;9417;56,7
3556404;Vargem Grande do Sul;2015;38684;1759;40443;95,65
3556453;Vargem Grande Paulista;2015;47985;0;47985;100
3556503;Várzea Paulista;2015;114351;0;114351;100
3556602;Vera Cruz;2015;9409;1215;10624;88,56
3556701;Vinhedo;2015;68803;2232;71035;96,86
3556800;Viradouro;2015;17332;522;17854;97,08
3556909;Vista Alegre do Alto;2015;7023;470;7493;93,73
3556958;Vitória Brasil;2015;1510;241;1751;86,24
3557006;Votorantim;2015;110072;4365;114437;96,19
3557105;Votuporanga;2015;85998;2479;88477;97,2
3557154;Zacarias;2015;2024;434;2458;82,34
3557204;Chavantes;2015;11367;801;12168;93,42
3557303;Estiva Gerbi;2015;8439;2142;10581;79,76
3500105;Adamantina;2020;32668;1226;33894;96,38
3500204;Adolfo;2020;3189;258;3447;92,52
3500303;Aguaí;2020;32833;2775;35608;92,21
3500402;Águas da Prata;2020;7188;609;7797;92,19
3500501;Águas de Lindóia;2020;18209;165;18374;99,1
3500550;Águas de Santa Bárbara;2020;4611;1320;5931;77,74
3500600;Águas de São Pedro;2020;3122;0;3122;100
3500709;Agudos;2020;34815;1319;36134;96,35
3500758;Alambari;2020;4729;1050;5779;81,83
3500808;Alfredo Marcondes;2020;3554;373;3927;90,5
3500907;Altair;2020;3413;623;4036;84,56
3501004;Altinópolis;2020;14272;1281;15553;91,76
3501103;Alto Alegre;2020;3412;605;4017;84,94
3501152;Alumínio;2020;15073;2899;17972;83,87
3501202;Álvares Florence;2020;2663;958;3621;73,54
3501301;Álvares Machado;2020;21720;2069;23789;91,3
3501400;Álvaro de Carvalho;2020;3400;1644;5044;67,41
3501509;Alvinlândia;2020;2929;247;3176;92,22
3501608;Americana;2020;232367;1091;233458;99,53
3501707;Américo Brasiliense;2020;39938;305;40243;99,24
3501806;Américo de Campos;2020;5025;711;5736;87,6
3501905;Amparo;2020;58620;11019;69639;84,18
3502002;Analândia;2020;4065;785;4850;83,81
3502101;Andradina;2020;52856;3198;56054;94,29
3502200;Angatuba;2020;18333;6168;24501;74,83
3502309;Anhembi;2020;5256;1416;6672;78,78
3502408;Anhumas;2020;3477;486;3963;87,74
3502507;Aparecida;2020;35190;519;35709;98,55
3502606;Aparecida d'Oeste;2020;3589;543;4132;86,86
3502705;Apiaí;2020;19995;4671;24666;81,06
3502754;Araçariguama;2020;20980;0;20980;100
3502804;Araçatuba;2020;186796;3673;190469;98,07
3502903;Araçoiaba da Serra;2020;22263;10127;32390;68,73
3503000;Aramina;2020;5293;203;5496;96,31
3503109;Arandu;2020;5087;1078;6165;82,51
3503158;Arapeí;2020;1920;551;2471;77,7
3503208;Araraquara;2020;221147;6471;227618;97,16
3503307;Araras;2020;124772;6285;131057;95,2
3503356;Arco-Íris;2020;1165;651;1816;64,15
3503406;Arealva;2020;6875;1321;8196;83,88
3503505;Areias;2020;2577;1266;3843;67,06
3503604;Areiópolis;2020;10062;795;10857;92,68
3503703;Ariranha;2020;8826;494;9320;94,7
3503802;Artur Nogueira;2020;47632;4977;52609;90,54
3503901;Arujá;2020;86429;3315;89744;96,31
3503950;Aspásia;2020;1322;443;1765;74,9
3504008;Assis;2020;96956;4425;101381;95,64
3504107;Atibaia;2020;130756;8850;139606;93,66
3504206;Auriflama;2020;13517;954;14471;93,41
3504305;Avaí;2020;3551;1737;5288;67,15
3504404;Avanhandava;2020;10243;1871;12114;84,56
3504503;Avaré;2020;84509;3029;87538;96,54
3504602;Bady Bassitt;2020;15333;996;16329;93,9
3504701;Balbinos;2020;1191;2513;3704;32,15
3504800;Bálsamo;2020;7948;576;8524;93,24
3504909;Bananal;2020;8994;1657;10651;84,44
3505005;Barão de Antonina;2020;2156;1227;3383;63,73
3505104;Barbosa;2020;6230;1054;7284;85,53
3505203;Bariri;2020;32762;1231;33993;96,38
3505302;Barra Bonita;2020;34268;646;34914;98,15
3505351;Barra do Chapéu;2020;1628;3902;5530;29,44
3505401;Barra do Turvo;2020;3591;4096;7687;46,72
3505500;Barretos;2020;114452;3596;118048;96,95
3505609;Barrinha;2020;31979;359;32338;98,89
3505708;Barueri;2020;264390;0;264390;100
3505807;Bastos;2020;18001;2300;20301;88,67
3505906;Batatais;2020;53258;6964;60222;88,44
3506003;Bauru;2020;358133;6092;364225;98,33
3506102;Bebedouro;2020;71307;2848;74155;96,16
3506201;Bento de Abreu;2020;2815;130;2945;95,59
3506300;Bernardino de Campos;2020;9869;918;10787;91,49
3506359;Bertioga;2020;62695;595;63290;99,06
3506409;Bilac;2020;7373;443;7816;94,33
3506508;Birigui;2020;118125;3204;121329;97,36
3506607;Biritiba Mirim;2020;28210;4128;32338;87,23
3506706;Boa Esperança do Sul;2020;13403;1179;14582;91,91
3506805;Bocaina;2020;11341;794;12135;93,46
3506904;Bofete;2020;7062;4014;11076;63,76
3507001;Boituva;2020;53893;3399;57292;94,07
3507100;Bom Jesus dos Perdões;2020;22118;2173;24291;91,05
3507159;Bom Sucesso de Itararé;2020;2885;976;3861;74,72
3507209;Borá;2020;632;180;812;77,83
3507308;Boracéia;2020;4342;417;4759;91,24
3507407;Borborema;2020;14405;918;15323;94,01
3507456;Borebi;2020;2400;179;2579;93,06
3507506;Botucatu;2020;136396;4739;141135;96,64
3507605;Bragança Paulista;2020;160871;3109;163980;98,1
3507704;Braúna;2020;5150;402;5552;92,76
3507753;Brejo Alegre;2020;2378;390;2768;85,91
3507803;Brodowski;2020;23647;296;23943;98,76
3507902;Brotas;2020;20735;3115;23850;86,94
3508009;Buri;2020;16462;3216;19678;83,66
3508108;Buritama;2020;15922;674;16596;95,94
3508207;Buritizal;2020;3611;696;4307;83,84
3508306;Cabrália Paulista;2020;3760;548;4308;87,28
3508405;Cabreúva;2020;44288;5142;49430;89,6
3508504;Caçapava;2020;78049;13168;91217;85,56
3508603;Cachoeira Paulista;2020;26907;5324;32231;83,48
3508702;Caconde;2020;13537;5317;18854;71,8
3508801;Cafelândia;2020;15529;1715;17244;90,05
3508900;Caiabu;2020;3506;597;4103;85,45
3509007;Caieiras;2020;98864;1748;100612;98,26
3509106;Caiuá;2020;2145;3455;5600;38,3
3509205;Cajamar;2020;76714;913;77627;98,82
3509254;Cajati;2020;21499;7493;28992;74,15
3509304;Cajobi;2020;9594;511;10105;94,94
3509403;Cajuru;2020;22937;2726;25663;89,38
3509452;Campina do Monte Alegre;2020;5120;692;5812;88,09
3509502;Campinas;2020;1155288;20213;1175501;98,28
3509601;Campo Limpo Paulista;2020;82842;0;82842;100
3509700;Campos do Jordão;2020;49805;313;50118;99,38
3509809;Campos Novos Paulista;2020;3981;836;4817;82,64
3509908;Cananéia;2020;10710;1631;12341;86,78
3509957;Canas;2020;4870;194;5064;96,17
3510005;Cândido Mota;2020;28537;1482;30019;95,06
3510104;Cândido Rodrigues;2020;2286;388;2674;85,49
3510153;Canitar;2020;4766;225;4991;95,49
3510203;Capão Bonito;2020;39459;6959;46418;85,01
3510302;Capela do Alto;2020;17817;2725;20542;86,73
3510401;Capivari;2020;52908;1323;54231;97,56
3510500;Caraguatatuba;2020;111793;4313;116106;96,29
3510609;Carapicuíba;2020;394598;0;394598;100
3510708;Cardoso;2020;10781;940;11721;91,98
3510807;Casa Branca;2020;24404;5058;29462;82,83
3510906;Cássia dos Coqueiros;2020;1916;579;2495;76,79
3511003;Castilho;2020;15642;5086;20728;75,46
3511102;Catanduva;2020;116265;941;117206;99,2
3511201;Catiguá;2020;7010;519;7529;93,11
3511300;Cedral;2020;7326;1510;8836;82,91
3511409;Cerqueira César;2020;17718;1495;19213;92,22
3511508;Cerquilho;2020;44009;2402;46411;94,82
3511607;Cesário Lange;2020;11645;5603;17248;67,52
3511706;Charqueada;2020;15491;1442;16933;91,48
3511904;Clementina;2020;8066;258;8324;96,9
3512001;Colina;2020;16781;822;17603;95,33
3512100;Colômbia;2020;4541;1505;6046;75,11
3512209;Conchal;2020;26382;902;27284;96,69
3512308;Conchas;2020;14628;2506;17134;85,37
3512407;Cordeirópolis;2020;21876;2480;24356;89,82
3512506;Coroados;2020;5081;845;5926;85,74
3512605;Coronel Macedo;2020;3969;874;4843;81,95
3512704;Corumbataí;2020;2475;1487;3962;62,47
3512803;Cosmópolis;2020;66201;5081;71282;92,87
3512902;Cosmorama;2020;5364;1633;6997;76,66
3513009;Cotia;2020;247424;0;247424;100
3513108;Cravinhos;2020;33919;509;34428;98,52
3513207;Cristais Paulista;2020;6987;1438;8425;82,93
3513306;Cruzália;2020;1508;609;2117;71,23
3513405;Cruzeiro;2020;78112;1815;79927;97,73
3513504;Cubatão;2020;129145;0;129145;100
3513603;Cunha;2020;13609;8072;21681;62,77
3513702;Descalvado;2020;30064;2366;32430;92,7
3513801;Diadema;2020;404477;0;404477;100
3513850;Dirce Reis;2020;1417;300;1717;82,53
3513900;Divinolândia;2020;8192;2694;10886;75,25
3514007;Dobrada;2020;8705;199;8904;97,77
3514106;Dois Córregos;2020;26113;859;26972;96,82
3514205;Dolcinópolis;2020;1915;125;2040;93,87
3514304;Dourado;2020;7778;704;8482;91,7
3514403;Dracena;2020;41798;3197;44995;92,89
3514502;Duartina;2020;11044;931;11975;92,23
3514601;Dumont;2020;9392;178;9570;98,14
3514700;Echaporã;2020;5145;1072;6217;82,76
3514809;Eldorado;2020;7498;7738;15236;49,21
3514908;Elias Fausto;2020;14606;2740;17346;84,2
3514924;Elisiário;2020;3267;232;3499;93,37
3514957;Embaúba;2020;2139;270;2409;88,79
3515004;Embu;2020;270790;0;270790;100
3515103;Embu-Guaçu;2020;66238;1815;68053;97,33
3515129;Emilianópolis;2020;2692;376;3068;87,74
3515152;Engenheiro Coelho;2020;15639;4896;20535;76,16
3515186;Espírito Santo do Pinhal;2020;38837;3736;42573;91,22
3515194;Espírito Santo do Turvo;2020;4105;694;4799;85,54
3515202;Estrela d'Oeste;2020;7059;1035;8094;87,21
3515301;Estrela do Norte;2020;2307;358;2665;86,57
3515350;Euclides da Cunha Paulista;2020;6155;3382;9537;64,54
3515400;Fartura;2020;13045;2599;15644;83,39
3515509;Fernandópolis;2020;64087;2025;66112;96,94
3515608;Fernando Prestes;2020;5043;529;5572;90,51
3515657;Fernão;2020;1009;640;1649;61,19
3515707;Ferraz de Vasconcelos;2020;184375;8662;193037;95,51
3515806;Flora Rica;2020;1386;203;1589;87,22
3515905;Floreal;2020;2420;436;2856;84,73
3516002;Flórida Paulista;2020;9563;2557;12120;78,9
3516101;Florínia;2020;2475;228;2703;91,56
3516200;Franca;2020;336119;6006;342125;98,24
3516309;Francisco Morato;2020;174048;355;174403;99,8
3516408;Franco da Rocha;2020;140219;11982;152201;92,13
3516507;Gabriel Monteiro;2020;2386;298;2684;88,9
3516606;Gália;2020;5089;1474;6563;77,54
3516705;Garça;2020;39806;2677;42483;93,7
3516804;Gastão Vidigal;2020;4473;295;4768;93,81
3516853;Gavião Peixoto;2020;4116;494;4610;89,28
3516903;General Salgado;2020;9424;1224;10648;88,5
3517000;Getulina;2020;8841;2006;10847;81,51
3517109;Glicério;2020;3659;1090;4749;77,05
3517208;Guaiçara;2020;11131;816;11947;93,17
3517307;Guaimbê;2020;5045;489;5534;91,16
3517406;Guaíra;2020;37840;1221;39061;96,87
3517505;Guapiaçu;2020;18942;1906;20848;90,86
3517604;Guapiara;2020;7499;10276;17775;42,19
3517703;Guará;2020;20329;495;20824;97,62
3517802;Guaraçai;2020;6910;1502;8412;82,14
3517901;Guaraci;2020;10201;777;10978;92,92
3518008;Guarani d'Oeste;2020;1718;204;1922;89,39
3518107;Guarantã;2020;5882;595;6477;90,81
3518206;Guararapes;2020;30158;1918;32076;94,02
3518305;Guararema;2020;25325;4104;29429;86,05
3518404;Guaratinguetá;2020;112868;5477;118345;95,37
3518503;Guareí;2020;9097;6653;15750;57,76
3518602;Guariba;2020;38406;615;39021;98,42
3518701;Guarujá;2020;316344;61;316405;99,98
3518800;Guarulhos;2020;1351275;0;1351275;100
3518859;Guatapará;2020;5982;1458;7440;80,4
3518909;Guzolândia;2020;4550;557;5107;89,09
3519006;Herculândia;2020;8671;589;9260;93,64
3519055;Holambra;2020;12287;2206;14493;84,78
3519071;Hortolândia;2020;230268;0;230268;100
3519105;Iacanga;2020;10025;1281;11306;88,67
3519204;Iacri;2020;5299;973;6272;84,49
3519253;Iaras;2020;3067;3827;6894;44,49
3519303;Ibaté;2020;33550;1188;34738;96,58
3519402;Ibirá;2020;11269;790;12059;93,45
3519501;Ibirarema;2020;7054;455;7509;93,94
3519600;Ibitinga;2020;56607;1894;58501;96,76
3519709;Ibiúna;2020;28199;48231;76430;36,9
3519808;Icém;2020;6963;1069;8032;86,69
3519907;Iepê;2020;7354;567;7921;92,84
3520004;Igaraçu do Tietê;2020;23997;138;24135;99,43
3520103;Igarapava;2020;28119;1337;29456;95,46
3520202;Igaratá;2020;7971;1341;9312;85,6
3520301;Iguape;2020;25834;3631;29465;87,68
3520400;Ilhabela;2020;33240;230;33470;99,31
3520426;Ilha Comprida;2020;10296;0;10296;100
3520442;Ilha Solteira;2020;24162;1586;25748;93,84
3520509;Indaiatuba;2020;240426;2442;242868;98,99
3520608;Indiana;2020;4209;566;4775;88,15
3520707;Indiaporã;2020;3491;363;3854;90,58
3520806;Inúbia Paulista;2020;3527;365;3892;90,62
3520905;Ipaussu;2020;13644;862;14506;94,06
3521002;Iperó;2020;21197;13155;34352;61,71
3521101;Ipeúna;2020;6860;711;7571;90,61
3521150;Ipiguá;2020;3383;1848;5231;64,67
3521200;Iporanga;2020;2894;1513;4407;65,67
3521309;Ipuã;2020;15355;506;15861;96,81
3521408;Iracemápolis;2020;23238;416;23654;98,24
3521507;Irapuã;2020;7132;602;7734;92,22
3521606;Irapuru;2020;5185;2149;7334;70,7
3521705;Itaberá;2020;13379;4235;17614;75,96
3521804;Itaí;2020;20814;5693;26507;78,52
3521903;Itajobi;2020;12840;1774;14614;87,86
3522000;Itaju;2020;2959;695;3654;80,98
3522109;Itanhaém;2020;98018;739;98757;99,25
3522158;Itaóca;2020;1737;1449;3186;54,52
3522208;Itapecerica da Serra;2020;168213;1406;169619;99,17
3522307;Itapetininga;2020;147379;12771;160150;92,03
3522406;Itapeva;2020;83413;8280;91693;90,97
3522505;Itapevi;2020;237714;0;237714;100
3522604;Itapira;2020;67027;4473;71500;93,74
3522653;Itapirapuã Paulista;2020;2146;2034;4180;51,34
3522703;Itápolis;2020;38966;2582;41548;93,79
3522802;Itaporanga;2020;11952;2736;14688;81,37
3522901;Itapuí;2020;13369;410;13779;97,02
3523008;Itapura;2020;3929;987;4916;79,92
3523107;Itaquaquecetuba;2020;370589;0;370589;100
3523206;Itararé;2020;45460;3558;49018;92,74
3523305;Itariri;2020;12323;4951;17274;71,34
3523404;Itatiba;2020;102739;15177;117916;87,13
3523503;Itatinga;2020;19190;1360;20550;93,38
3523602;Itirapina;2020;15873;1289;17162;92,49
3523701;Itirapuã;2020;5425;854;6279;86,4
3523800;Itobi;2020;7157;452;7609;94,06
3523909;Itu;2020;161437;8335;169772;95,09
3524006;Itupeva;2020;55279;3880;59159;93,44
3524105;Ituverava;2020;37890;2356;40246;94,15
3524204;Jaborandi;2020;6340;337;6677;94,95
3524303;Jaboticabal;2020;72946;1275;74221;98,28
3524402;Jacareí;2020;224797;3148;227945;98,62
3524501;Jaci;2020;6371;598;6969;91,42
3524600;Jacupiranga;2020;9377;7845;17222;54,45
3524709;Jaguariúna;2020;53844;1004;54848;98,17
3524808;Jales;2020;44467;2787;47254;94,1
3524907;Jambeiro;2020;2975;3239;6214;47,88
3525003;Jandira;2020;123603;0;123603;100
3525102;Jardinópolis;2020;42070;823;42893;98,08
3525201;Jarinu;2020;25692;4128;29820;86,16
3525300;Jaú;2020;143891;3614;147505;97,55
3525409;Jeriquara;2020;2733;408;3141;87,01
3525508;Joanópolis;2020;12666;0;12666;100
3525607;João Ramalho;2020;3903;481;4384;89,03
3525706;José Bonifácio;2020;33223;2758;35981;92,33
3525805;Júlio Mesquita;2020;4430;210;4640;95,47
3525854;Jumirim;2020;2175;1131;3306;65,79
3525904;Jundiaí;2020;395118;11898;407016;97,08
3526001;Junqueirópolis;2020;17068;2997;20065;85,06
3526100;Juquiá;2020;12310;6518;18828;65,38
3526209;Juquitiba;2020;26087;4314;30401;85,81
3526308;Lagoinha;2020;3421;1398;4819;70,99
3526407;Laranjal Paulista;2020;25207;2627;27834;90,56
3526506;Lavínia;2020;4148;4352;8500;48,8
3526605;Lavrinhas;2020;6741;426;7167;94,06
3526704;Leme;2020;99174;1801;100975;98,22
3526803;Lençóis Paulista;2020;65168;1175;66343;98,23
3526902;Limeira;2020;289378;6922;296300;97,66
3527009;Lindóia;2020;7722;0;7722;100
3527108;Lins;2020;74209;878;75087;98,83
3527207;Lorena;2020;84522;2117;86639;97,56
3527256;Lourdes;2020;1870;312;2182;85,7
3527306;Louveira;2020;47122;1146;48268;97,63
3527405;Lucélia;2020;18381;2638;21019;87,45
3527504;Lucianópolis;2020;1843;418;2261;81,51
3527603;Luís Antônio;2020;13961;205;14166;98,55
3527702;Luiziânia;2020;5441;313;5754;94,56
3527801;Lupércio;2020;4196;225;4421;94,91
3527900;Lutécia;2020;2197;424;2621;83,82
3528007;Macatuba;2020;16559;373;16932;97,8
3528106;Macaubal;2020;7028;721;7749;90,7
3528205;Macedônia;2020;2844;730;3574;79,57
3528304;Magda;2020;2641;447;3088;85,52
3528403;Mairinque;2020;37178;9145;46323;80,26
3528502;Mairiporã;2020;90911;7711;98622;92,18
3528601;Manduri;2020;8786;739;9525;92,24
3528700;Marabá Paulista;2020;2195;2736;4931;44,51
3528809;Maracaí;2020;12503;1018;13521;92,47
3528858;Marapoama;2020;2617;289;2906;90,06
3528908;Mariápolis;2020;3406;569;3975;85,69
3529005;Marília;2020;221166;10388;231554;95,51
3529104;Marinópolis;2020;1728;369;2097;82,4
3529203;Martinópolis;2020;22310;3358;25668;86,92
3529302;Matão;2020;78552;1468;80020;98,17
3529401;Mauá;2020;460132;0;460132;100
3529500;Mendonça;2020;4386;657;5043;86,97
3529609;Meridiano;2020;2709;1030;3739;72,45
3529658;Mesópolis;2020;1635;258;1893;86,37
3529708;Miguelópolis;2020;20459;965;21424;95,5
3529807;Mineiros do Tietê;2020;12034;563;12597;95,53
3529906;Miracatu;2020;10767;9167;19934;54,01
3530003;Mira Estrela;2020;1960;979;2939;66,69
3530102;Mirandópolis;2020;26161;2485;28646;91,33
3530201;Mirante do Paranapanema;2020;10463;7306;17769;58,88
3530300;Mirassol;2020;56363;1461;57824;97,47
3530409;Mirassolândia;2020;3823;879;4702;81,31
3530508;Mococa;2020;63433;3320;66753;95,03
3530607;Mogi das Cruzes;2020;401520;31385;432905;92,75
3530706;Mogi-Guaçu;2020;142302;6023;148325;95,94
3530805;Moji Mirim;2020;86584;3855;90439;95,74
3530904;Mombuca;2020;2948;384;3332;88,48
3531001;Monções;2020;1898;277;2175;87,26
3531100;Mongaguá;2020;54372;238;54610;99,56
3531209;Monte Alegre do Sul;2020;4827;2922;7749;62,29
3531308;Monte Alto;2020;46900;1505;48405;96,89
3531407;Monte Aprazível;2020;21781;1677;23458;92,85
3531506;Monte Azul Paulista;2020;17350;841;18191;95,38
3531605;Monte Castelo;2020;3336;655;3991;83,59
3531704;Monteiro Lobato;2020;1983;2482;4465;44,41
3531803;Monte Mor;2020;56936;2678;59614;95,51
3531902;Morro Agudo;2020;31558;774;32332;97,61
3532009;Morungaba;2020;11938;1309;13247;90,12
3532058;Motuca;2020;3705;933;4638;79,88
3532108;Murutinga do Sul;2020;2631;1650;4281;61,46
3532157;Nantes;2020;2937;134;3071;95,64
3532207;Narandiba;2020;3935;906;4841;81,28
3532306;Natividade da Serra;2020;2844;3854;6698;42,46
3532405;Nazaré Paulista;2020;17810;635;18445;96,56
3532504;Neves Paulista;2020;7932;688;8620;92,02
3532603;Nhandeara;2020;9057;1725;10782;84
3532702;Nipoã;2020;4510;459;4969;90,76
3532801;Nova Aliança;2020;5635;815;6450;87,36
3532827;Nova Campina;2020;7671;2004;9675;79,29
3532843;Nova Canaã Paulista;2020;979;958;1937;50,54
3532868;Nova Castilho;2020;938;238;1176;79,76
3532900;Nova Europa;2020;10204;545;10749;94,93
3533007;Nova Granada;2020;19592;1326;20918;93,66
3533106;Nova Guataporanga;2020;1969;222;2191;89,87
3533205;Nova Independência;2020;3172;559;3731;85,02
3533254;Novais;2020;5137;372;5509;93,25
3533304;Nova Lusitânia;2020;3782;262;4044;93,52
3533403;Nova Odessa;2020;57093;946;58039;98,37
3533502;Novo Horizonte;2020;36529;2425;38954;93,77
3533601;Nuporanga;2020;6926;342;7268;95,29
3533700;Ocauçu;2020;3582;564;4146;86,4
3533809;Óleo;2020;1818;709;2527;71,94
3533908;Olímpia;2020;50148;2368;52516;95,49
3534005;Onda Verde;2020;3597;628;4225;85,14
3534104;Oriente;2020;5956;309;6265;95,07
3534203;Orindiúva;2020;6405;461;6866;93,29
3534302;Orlândia;2020;41177;1089;42266;97,42
3534401;Osasco;2020;680964;0;680964;100
3534500;Oscar Bressane;2020;2203;311;2514;87,63
3534609;Osvaldo Cruz;2020;28537;2726;31263;91,28
3534708;Ourinhos;2020;107635;2854;110489;97,42
3534757;Ouroeste;2020;9111;666;9777;93,19
3534807;Ouro Verde;2020;7784;484;8268;94,15
3534906;Pacaembu;2020;9620;3436;13056;73,68
3535002;Palestina;2020;10458;1702;12160;86
3535101;Palmares Paulista;2020;12623;374;12997;97,12
3535200;Palmeira d'Oeste;2020;7428;1702;9130;81,36
3535309;Palmital;2020;20431;1168;21599;94,59
3535408;Panorama;2020;14870;329;15199;97,84
3535507;Paraguaçu Paulista;2020;40038;4142;44180;90,62
3535606;Paraibuna;2020;5496;12734;18230;30,15
3535705;Paraíso;2020;5706;563;6269;91,02
3535804;Paranapanema;2020;17183;2779;19962;86,08
3535903;Paranapuã;2020;3568;324;3892;91,68
3536000;Parapuã;2020;9053;1454;10507;86,16
3536109;Pardinho;2020;5657;735;6392;88,5
3536208;Pariquera-Açu;2020;13610;5641;19251;70,7
3536257;Parisi;2020;1719;335;2054;83,69
3536307;Patrocínio Paulista;2020;12307;2156;14463;85,09
3536406;Paulicéia;2020;6368;778;7146;89,11
3536505;Paulínia;2020;104940;97;105037;99,91
3536570;Paulistânia;2020;1379;390;1769;77,95
3536604;Paulo de Faria;2020;7814;707;8521;91,7
3536703;Pederneiras;2020;42380;3190;45570;93
3536802;Pedra Bela;2020;1711;4253;5964;28,69
3536901;Pedranópolis;2020;1548;874;2422;63,91
3537008;Pedregulho;2020;12172;4107;16279;74,77
3537107;Pedreira;2020;46157;391;46548;99,16
3537156;Pedrinhas Paulista;2020;2621;389;3010;87,08
3537206;Pedro de Toledo;2020;7759;3218;10977;70,68
3537305;Penápolis;2020;58877;1897;60774;96,88
3537404;Pereira Barreto;2020;23775;1616;25391;93,64
3537503;Pereiras;2020;5628;2800;8428;66,78
3537602;Peruíbe;2020;65798;403;66201;99,39
3537701;Piacatu;2020;5422;469;5891;92,04
3537800;Piedade;2020;25239;28297;53536;47,14
3537909;Pilar do Sul;2020;23491;4730;28221;83,24
3538006;Pindamonhangaba;2020;159147;4464;163611;97,27
3538105;Pindorama;2020;15386;869;16255;94,65
3538204;Pinhalzinho;2020;7429;7326;14755;50,35
3538303;Piquerobi;2020;2818;717;3535;79,72
3538501;Piquete;2020;12804;843;13647;93,82
3538600;Piracaia;2020;26287;0;26287;100
3538709;Piracicaba;2020;382790;7083;389873;98,18
3538808;Piraju;2020;26324;2250;28574;92,13
3538907;Pirajuí;2020;19075;4184;23259;82,01
3539004;Pirangi;2020;9951;872;10823;91,94
3539103;Pirapora do Bom Jesus;2020;18851;0;18851;100
3539202;Pirapozinho;2020;26103;1110;27213;95,92
3539301;Pirassununga;2020;69037;4669;73706;93,67
3539400;Piratininga;2020;11570;1643;13213;87,57
3539509;Pitangueiras;2020;37614;970;38584;97,49
3539608;Planalto;2020;4585;582;5167;88,74
3539707;Platina;2020;2894;607;3501;82,66
3539806;Poá;2020;113713;1825;115538;98,42
3539905;Poloni;2020;5044;623;5667;89,01
3540002;Pompéia;2020;19954;1328;21282;93,76
3540101;Pongaí;2020;2951;400;3351;88,06
3540200;Pontal;2020;48784;499;49283;98,99
3540259;Pontalinda;2020;3929;558;4487;87,56
3540309;Pontes Gestal;2020;2249;279;2528;88,96
3540408;Populina;2020;3351;644;3995;83,88
3540507;Porangaba;2020;4495;4815;9310;48,28
3540606;Porto Feliz;2020;45016;6681;51697;87,08
3540705;Porto Ferreira;2020;53132;970;54102;98,21
3540754;Potim;2020;15699;5003;20702;75,83
3540804;Potirendaba;2020;15278;1327;16605;92,01
3540853;Pracinha;2020;1395;1518;2913;47,89
3540903;Pradópolis;2020;19502;1405;20907;93,28
3541000;Praia Grande;2020;316844;0;316844;100
3541059;Pratânia;2020;4203;953;5156;81,52
3541109;Presidente Alves;2020;3537;483;4020;87,99
3541208;Presidente Bernardes;2020;11480;2240;13720;83,67
3541307;Presidente Epitácio;2020;39839;2561;42400;93,96
3541406;Presidente Prudente;2020;216563;4510;221073;97,96
3541505;Presidente Venceslau;2020;36873;1132;38005;97,02
3541604;Promissão;2020;34106;5561;39667;85,98
3541653;Quadra;2020;960;2748;3708;25,89
3541703;Quatá;2020;13234;701;13935;94,97
3541802;Queiroz;2020;2949;330;3279;89,94
3541901;Queluz;2020;10370;2274;12644;82,02
3542008;Quitana;2020;6009;491;6500;92,45
3542107;Rafard;2020;8089;887;8976;90,12
3542206;Rancharia;2020;26488;2359;28847;91,82
3542305;Redenção da Serra;2020;2773;1064;3837;72,27
3542404;Regente Feijó;2020;18302;1189;19491;93,9
3542503;Reginópolis;2020;4298;2917;7215;59,57
3542602;Registro;2020;48129;6087;54216;88,77
3542701;Restinga;2020;6176;1317;7493;82,42
3542800;Ribeira;2020;1483;1759;3242;45,74
3542909;Ribeirão Bonito;2020;12265;694;12959;94,64
3543006;Ribeirão Branco;2020;10493;7192;17685;59,33
3543105;Ribeirão Corrente;2020;3860;804;4664;82,76
3543204;Ribeirão do Sul;2020;3572;788;4360;81,93
3543238;Ribeirão dos Índios;2020;1897;244;2141;88,6
3543253;Ribeirão Grande;2020;2381;5129;7510;31,7
3543303;Ribeirão Pires;2020;118968;0;118968;100
3543402;Ribeirão Preto;2020;681837;1940;683777;99,72
3543501;Riversul;2020;4307;1398;5705;75,5
3543600;Rifaina;2020;3078;390;3468;88,75
3543709;Rincão;2020;8655;1841;10496;82,46
3543808;Rinópolis;2020;8910;810;9720;91,67
3543907;Rio Claro;2020;196819;4393;201212;97,82
3544004;Rio das Pedras;2020;33676;740;34416;97,85
3544103;Rio Grande da Serra;2020;49816;0;49816;100
3544202;Riolândia;2020;9043;2388;11431;79,11
3544251;Rosana;2020;17719;668;18387;96,37
3544301;Roseira;2020;10216;426;10642;96
3544400;Rubiácea;2020;1871;1235;3106;60,24
3544509;Rubinéia;2020;2621;368;2989;87,69
3544608;Sabino;2020;4991;477;5468;91,28
3544707;Sagres;2020;1989;373;2362;84,21
3544806;Sales;2020;5631;419;6050;93,07
3544905;Sales Oliveira;2020;10850;668;11518;94,2
3545001;Salesópolis;2020;11173;5665;16838;66,36
3545100;Salmourão;2020;4818;299;5117;94,16
3545159;Saltinho;2020;6594;1266;7860;83,89
3545209;Salto;2020;114561;811;115372;99,3
3545308;Salto de Pirapora;2020;34810;9413;44223;78,71
3545407;Salto Grande;2020;8380;715;9095;92,14
3545506;Sandovalina;2020;3371;840;4211;80,05
3545605;Santa Adélia;2020;14089;803;14892;94,61
3545704;Santa Albertina;2020;5057;615;5672;89,16
3545803;Santa Bárbara d'Oeste;2020;187263;1482;188745;99,21
3546009;Santa Branca;2020;12507;1672;14179;88,21
3546108;Santa Clara d'Oeste;2020;1614;392;2006;80,46
3546207;Santa Cruz da Conceição;2020;3398;951;4349;78,13
3546256;Santa Cruz da Esperança;2020;1429;648;2077;68,8
3546306;Santa Cruz das Palmeiras;2020;32998;731;33729;97,83
3546405;Santa Cruz do Rio Pardo;2020;43274;2836;46110;93,85
3546504;Santa Ernestina;2020;5316;209;5525;96,22
3546603;Santa Fé do Sul;2020;29591;1213;30804;96,06
3546702;Santa Gertrudes;2020;25911;278;26189;98,94
3546801;Santa Isabel;2020;44716;10370;55086;81,17
3546900;Santa Lucia;2020;8208;354;8562;95,87
3547007;Santa Maria da Serra;2020;5583;558;6141;90,91
3547106;Santa Mercedes;2020;2572;241;2813;91,43
3547205;Santana da Ponte Pensa;2020;1116;393;1509;73,96
3547304;Santana de Parnaíba;2020;138132;0;138132;100
3547403;Santa Rita d'Oeste;2020;1895;509;2404;78,83
3547502;Santa Rita do Passa Quatro;2020;24263;2122;26385;91,96
3547601;Santa Rosa do Viterbo;2020;24636;968;25604;96,22
3547650;Santa Salete;2020;1031;409;1440;71,6
3547700;Santo Anastácio;2020;18977;1150;20127;94,29
3547809;Santo André;2020;693867;0;693867;100
3547908;Santo Antonio da Alegria;2020;4999;1638;6637;75,32
3548005;Santo Antonio da Posse;2020;21842;1007;22849;95,59
3548054;Santo Antonio do Aracanguá;2020;7174;1078;8252;86,94
3548104;Santo Antonio do Jardim;2020;3806;2020;5826;65,33
3548203;Santo Antonio do Pinhal;2020;4631;1997;6628;69,87
3548302;Santo Expedito;2020;2774;198;2972;93,34
3548401;Santópolis do Aguapeí;2020;4555;113;4668;97,58
3548500;Santos;2020;428382;321;428703;99,93
3548609;São Bento do Sapucaí;2020;5435;5095;10530;51,61
3548708;São Bernardo do Campo;2020;799027;13059;812086;98,39
3548807;São Caetano do Sul;2020;151244;0;151244;100
3548906;São Carlos;2020;232915;9717;242632;96
3549003;São Francisco;2020;2198;479;2677;82,11
3549102;São João da Boa Vista;2020;85046;2294;87340;97,37
3549201;São João das Duas Pontes;2020;1908;568;2476;77,06
3549250;São João de Iracema;2020;1652;198;1850;89,3
3549300;São João do Pau d'Alho;2020;1716;269;1985;86,45
3549409;São Joaquim da Barra;2020;49386;888;50274;98,23
3549508;São José da Bela Vista;2020;7961;766;8727;91,22
3549607;São José do Barreiro;2020;3217;853;4070;79,04
3549706;São José do Rio Pardo;2020;49041;4165;53206;92,17
3549805;São José do Rio Preto;2020;420750;27174;447924;93,93
3549904;São José dos Campos;2020;696197;14457;710654;97,97
3549953;São Lourenço da Serra;2020;14499;1080;15579;93,07
3550001;São Luís do Paraitinga;2020;6337;4232;10569;59,96
3550100;São Manuel;2020;39042;532;39574;98,66
3550209;São Miguel Arcanjo;2020;24583;7417;32000;76,82
3550308;São Paulo;2020;11762962;106698;11869660;99,1
3550407;São Pedro;2020;29769;4439;34208;87,02
3550506;São Pedro do Turvo;2020;5739;1630;7369;77,88
3550605;São Roque;2020;84550;2885;87435;96,7
3550704;São Sebastião;2020;86153;982;87135;98,87
3550803;São Sebastião da Grama;2020;8489;3447;11936;71,12
3550902;São Simão;2020;13710;1137;14847;92,34
3551009;São Vicente;2020;357253;676;357929;99,81
3551108;Sarapuí;2020;8130;1980;10110;80,42
3551207;Sarutaiá;2020;3149;497;3646;86,37
3551306;Sebastianópolis do Sul;2020;2810;483;3293;85,33
3551405;Serra Azul;2020;8748;3534;12282;71,23
3551504;Serrana;2020;44183;251;44434;99,44
3551603;Serra Negra;2020;23897;3543;27440;87,09
3551702;Sertãozinho;2020;121772;583;122355;99,52
3551801;Sete Barras;2020;9143;3485;12628;72,4
3551900;Severínia;2020;16546;580;17126;96,61
3552007;Silveiras;2020;3339;2865;6204;53,82
3552106;Socorro;2020;27762;11021;38783;71,58
3552205;Sorocaba;2020;651845;6702;658547;98,98
3552304;Sud Mennucci;2020;6644;1069;7713;86,14
3552403;Sumaré;2020;279878;3334;283212;98,82
3552502;Suzano;2020;280758;10244;291002;96,48
3552551;Suzanópolis;2020;2634;1313;3947;66,73
3552601;Tabapuã;2020;11145;747;11892;93,72
3552700;Tabatinga;2020;14361;1536;15897;90,34
3552809;Taboão da Serra;2020;283871;0;283871;100
3552908;Taciba;2020;5320;734;6054;87,88
3553005;Taguaí;2020;9542;3777;13319;71,64
3553104;Taiaçu;2020;5629;408;6037;93,24
3553203;Taiúva;2020;5894;384;6278;93,88
3553302;Tambaú;2020;20834;1969;22803;91,37
3553401;Tanabi;2020;23378;1727;25105;93,12
3553500;Tapiraí;2020;5785;1914;7699;75,14
3553609;Tapiratiba;2020;11298;1312;12610;89,6
3553658;Taquaral;2020;2660;91;2751;96,69
3553708;Taquaritinga;2020;52424;2075;54499;96,19
3553807;Taquarituba;2020;21137;2056;23193;91,14
3553856;Taquarivaí;2020;3337;2409;5746;58,08
3553906;Tarabaí;2020;6834;435;7269;94,02
3553955;Tarumã;2020;14093;713;14806;95,18
3554003;Tatuí;2020;116699;3424;120123;97,15
3554102;Taubaté;2020;301096;6265;307361;97,96
3554201;Tejupá;2020;3593;1104;4697;76,5
3554300;Teodoro Sampaio;2020;18533;3881;22414;82,68
3554409;Terra Roxa;2020;8779;342;9121;96,25
3554508;Tietê;2020;37528;3545;41073;91,37
3554607;Timburi;2020;1996;561;2557;78,06
3554656;Torre de Pedra;2020;1651;669;2320;71,16
3554706;Torrinha;2020;8482;1231;9713;87,33
3554755;Trabiju;2020;1595;108;1703;93,66
3554805;Tremembé;2020;42766;3212;45978;93,01
3554904;Três Fronteiras;2020;4908;639;5547;88,48
3554953;Tuiuti;2020;3560;2997;6557;54,29
3555000;Tupã;2020;60322;2521;62843;95,99
3555109;Tupi Paulista;2020;11685;3193;14878;78,54
3555208;Turiúba;2020;1618;294;1912;84,62
3555307;Turmalina;2020;1373;432;1805;76,07
3555356;Ubarana;2020;5608;458;6066;92,45
3555406;Ubatuba;2020;86842;2074;88916;97,67
3555505;Ubirajara;2020;3439;1224;4663;73,75
3555604;Uchôa;2020;9082;601;9683;93,79
3555703;União Paulista;2020;1399;340;1739;80,45
3555802;Urânia;2020;7504;1107;8611;87,14
3555901;Uru;2020;1132;75;1207;93,79
3556008;Urupês;2020;12090;1074;13164;91,84
3556107;Valentim Gentil;2020;11859;911;12770;92,87
3556206;Valinhos;2020;119288;5454;124742;95,63
3556305;Valparaíso;2020;23353;635;23988;97,35
3556354;Vargem;2020;6290;3710;10000;62,9
3556404;Vargem Grande do Sul;2020;39933;1568;41501;96,22
3556453;Vargem Grande Paulista;2020;52762;0;52762;100
3556503;Várzea Paulista;2020;120535;0;120535;100
3556602;Vera Cruz;2020;9460;1064;10524;89,89
3556701;Vinhedo;2020;75085;2436;77521;96,86
3556800;Viradouro;2020;17810;537;18347;97,07
3556909;Vista Alegre do Alto;2020;7594;420;8014;94,76
3556958;Vitória Brasil;2020;1562;198;1760;88,75
3557006;Votorantim;2020;115254;4570;119824;96,19
3557105;Votuporanga;2020;89189;2571;91760;97,2
3557154;Zacarias;2020;2183;377;2560;85,27
3557204;Chavantes;2020;11525;698;12223;94,29
3557303;Estiva Gerbi;2020;8837;2242;11079;79,76
3500105;Adamantina;2025;32725;1048;33773;96,9
3500204;Adolfo;2025;3161;235;3396;93,08
3500303;Aguaí;2025;34432;2582;37014;93,02
3500402;Águas da Prata;2025;7319;527;7846;93,28
3500501;Águas de Lindóia;2025;18530;168;18698;99,1
3500550;Águas de Santa Bárbara;2025;4765;1299;6064;78,58
3500600;Águas de São Pedro;2025;3234;0;3234;100
3500709;Agudos;2025;35515;1229;36744;96,66
3500758;Alambari;2025;5224;953;6177;84,57
3500808;Alfredo Marcondes;2025;3624;287;3911;92,66
3500907;Altair;2025;3568;549;4117;86,67
3501004;Altinópolis;2025;14493;1028;15521;93,38
3501103;Alto Alegre;2025;3461;502;3963;87,33
3501152;Alumínio;2025;15483;2978;18461;83,87
3501202;Álvares Florence;2025;2655;839;3494;75,99
3501301;Álvares Machado;2025;22027;1957;23984;91,84
3501400;Álvaro de Carvalho;2025;3615;1604;5219;69,27
3501509;Alvinlândia;2025;3020;226;3246;93,04
3501608;Americana;2025;240522;1129;241651;99,53
3501707;Américo Brasiliense;2025;42131;321;42452;99,24
3501806;Américo de Campos;2025;5077;632;5709;88,93
3501905;Amparo;2025;61131;9622;70753;86,4
3502002;Analândia;2025;4353;727;5080;85,69
3502101;Andradina;2025;53240;2979;56219;94,7
3502200;Angatuba;2025;19441;6060;25501;76,24
3502309;Anhembi;2025;5698;1402;7100;80,25
3502408;Anhumas;2025;3654;411;4065;89,89
3502507;Aparecida;2025;35359;522;35881;98,55
3502606;Aparecida d'Oeste;2025;3540;457;3997;88,57
3502705;Apiaí;2025;21041;3854;24895;84,52
3502754;Araçariguama;2025;22573;0;22573;100
3502804;Araçatuba;2025;189031;3717;192748;98,07
3502903;Araçoiaba da Serra;2025;23873;10859;34732;68,73
3503000;Aramina;2025;5427;167;5594;97,01
3503109;Arandu;2025;5277;903;6180;85,39
3503158;Arapeí;2025;1942;521;2463;78,85
3503208;Araraquara;2025;226910;6640;233550;97,16
3503307;Araras;2025;129340;6146;135486;95,46
3503356;Arco-Íris;2025;1190;574;1764;67,46
3503406;Arealva;2025;7164;1167;8331;85,99
3503505;Areias;2025;2636;1296;3932;67,04
3503604;Areiópolis;2025;10412;660;11072;94,04
3503703;Ariranha;2025;9104;510;9614;94,7
3503802;Artur Nogueira;2025;50483;5274;55757;90,54
3503901;Arujá;2025;92569;3414;95983;96,44
3503950;Aspásia;2025;1346;396;1742;77,27
3504008;Assis;2025;99099;4523;103622;95,64
3504107;Atibaia;2025;136800;7790;144590;94,61
3504206;Auriflama;2025;13668;834;14502;94,25
3504305;Avaí;2025;3639;1780;5419;67,15
3504404;Avanhandava;2025;10565;1930;12495;84,55
3504503;Avaré;2025;86343;2792;89135;96,87
3504602;Bady Bassitt;2025;15868;1026;16894;93,93
3504701;Balbinos;2025;1194;2519;3713;32,16
3504800;Bálsamo;2025;8059;555;8614;93,56
3504909;Bananal;2025;9372;1479;10851;86,37
3505005;Barão de Antonina;2025;2276;1232;3508;64,88
3505104;Barbosa;2025;6533;1063;7596;86,01
3505203;Bariri;2025;33843;1095;34938;96,87
3505302;Barra Bonita;2025;34044;620;34664;98,21
3505351;Barra do Chapéu;2025;1674;4011;5685;29,45
3505401;Barra do Turvo;2025;3864;3938;7802;49,53
3505500;Barretos;2025;116261;3653;119914;96,95
3505609;Barrinha;2025;33590;377;33967;98,89
3505708;Barueri;2025;273751;0;273751;100
3505807;Bastos;2025;18184;2091;20275;89,69
3505906;Batatais;2025;54508;7128;61636;88,44
3506003;Bauru;2025;364554;6202;370756;98,33
3506102;Bebedouro;2025;70599;2633;73232;96,4
3506201;Bento de Abreu;2025;2947;104;3051;96,59
3506300;Bernardino de Campos;2025;9974;844;10818;92,2
3506359;Bertioga;2025;69213;501;69714;99,28
3506409;Bilac;2025;7624;388;8012;95,16
3506508;Birigui;2025;122398;3157;125555;97,49
3506607;Biritiba Mirim;2025;29967;4130;34097;87,89
3506706;Boa Esperança do Sul;2025;13905;1064;14969;92,89
3506805;Bocaina;2025;11922;760;12682;94,01
3506904;Bofete;2025;7447;4233;11680;63,76
3507001;Boituva;2025;57240;3610;60850;94,07
3507100;Bom Jesus dos Perdões;2025;23978;2029;26007;92,2
3507159;Bom Sucesso de Itararé;2025;3131;900;4031;77,67
3507209;Borá;2025;630;179;809;77,87
3507308;Boracéia;2025;4556;401;4957;91,91
3507407;Borborema;2025;14793;767;15560;95,07
3507456;Borebi;2025;2554;142;2696;94,73
3507506;Botucatu;2025;141280;4705;145985;96,78
3507605;Bragança Paulista;2025;167345;3038;170383;98,22
3507704;Braúna;2025;5434;325;5759;94,36
3507753;Brejo Alegre;2025;2478;353;2831;87,53
3507803;Brodowski;2025;24672;229;24901;99,08
3507902;Brotas;2025;21658;3151;24809;87,3
3508009;Buri;2025;17327;3068;20395;84,96
3508108;Buritama;2025;16384;596;16980;96,49
3508207;Buritizal;2025;3723;663;4386;84,88
3508306;Cabrália Paulista;2025;3767;532;4299;87,63
3508405;Cabreúva;2025;48372;4563;52935;91,38
3508504;Caçapava;2025;79904;13481;93385;85,56
3508603;Cachoeira Paulista;2025;27816;5170;32986;84,33
3508702;Caconde;2025;13999;5047;19046;73,5
3508801;Cafelândia;2025;15940;1515;17455;91,32
3508900;Caiabu;2025;3583;529;4112;87,14
3509007;Caieiras;2025;104819;1607;106426;98,49
3509106;Caiuá;2025;2229;3589;5818;38,31
3509205;Cajamar;2025;82729;866;83595;98,96
3509254;Cajati;2025;22123;7495;29618;74,69
3509304;Cajobi;2025;9730;467;10197;95,42
3509403;Cajuru;2025;23834;2774;26608;89,57
3509452;Campina do Monte Alegre;2025;5293;618;5911;89,54
3509502;Campinas;2025;1185353;20739;1206092;98,28
3509601;Campo Limpo Paulista;2025;86344;0;86344;100
3509700;Campos do Jordão;2025;50755;318;51073;99,38
3509809;Campos Novos Paulista;2025;4181;758;4939;84,65
3509908;Cananéia;2025;10936;1596;12532;87,26
3509957;Canas;2025;5186;165;5351;96,92
3510005;Cândido Mota;2025;28555;1419;29974;95,27
3510104;Cândido Rodrigues;2025;2327;336;2663;87,38
3510153;Canitar;2025;5056;238;5294;95,5
3510203;Capão Bonito;2025;40541;6396;46937;86,37
3510302;Capela do Alto;2025;19447;2561;22008;88,36
3510401;Capivari;2025;55396;1148;56544;97,97
3510500;Caraguatatuba;2025;116826;4285;121111;96,46
3510609;Carapicuíba;2025;403931;0;403931;100
3510708;Cardoso;2025;10781;891;11672;92,37
3510807;Casa Branca;2025;24919;4985;29904;83,33
3510906;Cássia dos Coqueiros;2025;1974;480;2454;80,44
3511003;Castilho;2025;16446;5347;21793;75,46
3511102;Catanduva;2025;117298;950;118248;99,2
3511201;Catiguá;2025;7151;508;7659;93,37
3511300;Cedral;2025;7718;1419;9137;84,47
3511409;Cerqueira César;2025;18564;1345;19909;93,24
3511508;Cerquilho;2025;46535;2539;49074;94,83
3511607;Cesário Lange;2025;12027;5787;17814;67,51
3511706;Charqueada;2025;16217;1442;17659;91,83
3511904;Clementina;2025;8543;236;8779;97,31
3512001;Colina;2025;16886;729;17615;95,86
3512100;Colômbia;2025;4628;1426;6054;76,45
3512209;Conchal;2025;27329;770;28099;97,26
3512308;Conchas;2025;15244;2239;17483;87,19
3512407;Cordeirópolis;2025;23063;2614;25677;89,82
3512506;Coroados;2025;5393;759;6152;87,66
3512605;Coronel Macedo;2025;4048;773;4821;83,97
3512704;Corumbataí;2025;2656;1342;3998;66,43
3512803;Cosmópolis;2025;70653;5422;76075;92,87
3512902;Cosmorama;2025;5506;1385;6891;79,9
3513009;Cotia;2025;267860;0;267860;100
3513108;Cravinhos;2025;35074;412;35486;98,84
3513207;Cristais Paulista;2025;7597;1175;8772;86,61
3513306;Cruzália;2025;1511;546;2057;73,46
3513405;Cruzeiro;2025;79162;1776;80938;97,81
3513504;Cubatão;2025;133607;0;133607;100
3513603;Cunha;2025;14269;7309;21578;66,13
3513702;Descalvado;2025;30839;2024;32863;93,84
3513801;Diadema;2025;410109;0;410109;100
3513850;Dirce Reis;2025;1451;256;1707;85
3513900;Divinolândia;2025;8494;2286;10780;78,79
3514007;Dobrada;2025;9109;208;9317;97,77
3514106;Dois Córregos;2025;27142;736;27878;97,36
3514205;Dolcinópolis;2025;1883;122;2005;93,92
3514304;Dourado;2025;7717;685;8402;91,85
3514403;Dracena;2025;42348;3113;45461;93,15
3514502;Duartina;2025;11002;804;11806;93,19
3514601;Dumont;2025;9887;138;10025;98,62
3514700;Echaporã;2025;5188;981;6169;84,1
3514809;Eldorado;2025;7734;7982;15716;49,21
3514908;Elias Fausto;2025;15434;2486;17920;86,13
3514924;Elisiário;2025;3365;228;3593;93,65
3514957;Embaúba;2025;2159;234;2393;90,22
3515004;Embu;2025;283399;0;283399;100
3515103;Embu-Guaçu;2025;68769;1884;70653;97,33
3515129;Emilianópolis;2025;2752;317;3069;89,67
3515152;Engenheiro Coelho;2025;17331;5012;22343;77,57
3515186;Espírito Santo do Pinhal;2025;39550;3354;42904;92,18
3515194;Espírito Santo do Turvo;2025;4326;732;5058;85,53
3515202;Estrela d'Oeste;2025;7129;913;8042;88,65
3515301;Estrela do Norte;2025;2392;287;2679;89,29
3515350;Euclides da Cunha Paulista;2025;6231;3365;9596;64,93
3515400;Fartura;2025;13436;2383;15819;84,94
3515509;Fernandópolis;2025;64178;2028;66206;96,94
3515608;Fernando Prestes;2025;5127;427;5554;92,31
3515657;Fernão;2025;1086;600;1686;64,41
3515707;Ferraz de Vasconcelos;2025;194780;9150;203930;95,51
3515806;Flora Rica;2025;1363;159;1522;89,55
3515905;Floreal;2025;2402;386;2788;86,15
3516002;Flórida Paulista;2025;9331;2495;11826;78,9
3516101;Florínia;2025;2470;200;2670;92,51
3516200;Franca;2025;344430;6155;350585;98,24
3516309;Francisco Morato;2025;183965;375;184340;99,8
3516408;Franco da Rocha;2025;148224;12666;160890;92,13
3516507;Gabriel Monteiro;2025;2410;241;2651;90,91
3516606;Gália;2025;5079;1357;6436;78,92
3516705;Garça;2025;39637;2358;41995;94,39
3516804;Gastão Vidigal;2025;4743;245;4988;95,09
3516853;Gavião Peixoto;2025;4310;385;4695;91,8
3516903;General Salgado;2025;9495;1070;10565;89,87
3517000;Getulina;2025;9071;1819;10890;83,3
3517109;Glicério;2025;3784;1029;4813;78,62
3517208;Guaiçara;2025;11703;739;12442;94,06
3517307;Guaimbê;2025;5183;416;5599;92,57
3517406;Guaíra;2025;38315;1216;39531;96,92
3517505;Guapiaçu;2025;20093;1833;21926;91,64
3517604;Guapiara;2025;7803;10260;18063;43,2
3517703;Guará;2025;20787;460;21247;97,83
3517802;Guaraçai;2025;6985;1370;8355;83,6
3517901;Guaraci;2025;10662;680;11342;94
3518008;Guarani d'Oeste;2025;1706;191;1897;89,93
3518107;Guarantã;2025;6041;477;6518;92,68
3518206;Guararapes;2025;30744;1753;32497;94,61
3518305;Guararema;2025;26674;4323;30997;86,05
3518404;Guaratinguetá;2025;114832;5506;120338;95,42
3518503;Guareí;2025;9372;6854;16226;57,76
3518602;Guariba;2025;39807;557;40364;98,62
3518701;Guarujá;2025;328365;63;328428;99,98
3518800;Guarulhos;2025;1405048;0;1405048;100
3518859;Guatapará;2025;6375;1276;7651;83,32
3518909;Guzolândia;2025;4760;483;5243;90,79
3519006;Herculândia;2025;8969;542;9511;94,3
3519055;Holambra;2025;13872;1745;15617;88,83
3519071;Hortolândia;2025;247142;0;247142;100
3519105;Iacanga;2025;10574;1259;11833;89,36
3519204;Iacri;2025;5360;824;6184;86,68
3519253;Iaras;2025;3179;3965;7144;44,5
3519303;Ibaté;2025;35118;1181;36299;96,75
3519402;Ibirá;2025;11642;786;12428;93,68
3519501;Ibirarema;2025;7382;437;7819;94,41
3519600;Ibitinga;2025;58462;1856;60318;96,92
3519709;Ibiúna;2025;29768;48873;78641;37,85
3519808;Icém;2025;7192;1067;8259;87,08
3519907;Iepê;2025;7564;469;8033;94,16
3520004;Igaraçu do Tietê;2025;24352;140;24492;99,43
3520103;Igarapava;2025;28750;1228;29978;95,9
3520202;Igaratá;2025;8381;1143;9524;88
3520301;Iguape;2025;26364;3550;29914;88,13
3520400;Ilhabela;2025;35021;243;35264;99,31
3520426;Ilha Comprida;2025;10882;0;10882;100
3520442;Ilha Solteira;2025;24190;1588;25778;93,84
3520509;Indaiatuba;2025;253049;2570;255619;98,99
3520608;Indiana;2025;4242;510;4752;89,27
3520707;Indiaporã;2025;3503;317;3820;91,7
3520806;Inúbia Paulista;2025;3671;326;3997;91,84
3520905;Ipaussu;2025;14063;809;14872;94,56
3521002;Iperó;2025;22615;14034;36649;61,71
3521101;Ipeúna;2025;7653;643;8296;92,25
3521150;Ipiguá;2025;3674;1835;5509;66,69
3521200;Iporanga;2025;3148;1341;4489;70,13
3521309;Ipuã;2025;16099;475;16574;97,13
3521408;Iracemápolis;2025;24518;432;24950;98,27
3521507;Irapuã;2025;7338;560;7898;92,91
3521606;Irapuru;2025;5044;2091;7135;70,69
3521705;Itaberá;2025;13980;3635;17615;79,36
3521804;Itaí;2025;21681;5930;27611;78,52
3521903;Itajobi;2025;13006;1549;14555;89,36
3522000;Itaju;2025;3221;603;3824;84,23
3522109;Itanhaém;2025;103132;695;103827;99,33
3522158;Itaóca;2025;1742;1453;3195;54,52
3522208;Itapecerica da Serra;2025;175802;1469;177271;99,17
3522307;Itapetininga;2025;154679;12388;167067;92,59
3522406;Itapeva;2025;87439;6427;93866;93,15
3522505;Itapevi;2025;255399;0;255399;100
3522604;Itapira;2025;67846;4200;72046;94,17
3522653;Itapirapuã Paulista;2025;2292;2063;4355;52,63
3522703;Itápolis;2025;39839;2213;42052;94,74
3522802;Itaporanga;2025;12389;2407;14796;83,73
3522901;Itapuí;2025;14091;370;14461;97,44
3523008;Itapura;2025;4130;1038;5168;79,91
3523107;Itaquaquecetuba;2025;393161;0;393161;100
3523206;Itararé;2025;46166;3515;49681;92,92
3523305;Itariri;2025;13490;4644;18134;74,39
3523404;Itatiba;2025;109378;14492;123870;88,3
3523503;Itatinga;2025;20356;1226;21582;94,32
3523602;Itirapina;2025;16613;1174;17787;93,4
3523701;Itirapuã;2025;5651;792;6443;87,71
3523800;Itobi;2025;7245;360;7605;95,27
3523909;Itu;2025;168094;7587;175681;95,68
3524006;Itupeva;2025;61724;3119;64843;95,19
3524105;Ituverava;2025;38302;2381;40683;94,15
3524204;Jaborandi;2025;6391;306;6697;95,43
3524303;Jaboticabal;2025;73883;994;74877;98,67
3524402;Jacareí;2025;230867;3233;234100;98,62
3524501;Jaci;2025;6839;552;7391;92,53
3524600;Jacupiranga;2025;9417;7880;17297;54,44
3524709;Jaguariúna;2025;57050;1018;58068;98,25
3524808;Jales;2025;44409;2784;47193;94,1
3524907;Jambeiro;2025;3117;3394;6511;47,87
3525003;Jandira;2025;130437;0;130437;100
3525102;Jardinópolis;2025;44139;607;44746;98,64
3525201;Jarinu;2025;28970;3492;32462;89,24
3525300;Jaú;2025;149698;3430;153128;97,76
3525409;Jeriquara;2025;2790;350;3140;88,85
3525508;Joanópolis;2025;12942;0;12942;100
3525607;João Ramalho;2025;4048;433;4481;90,34
3525706;José Bonifácio;2025;34570;2670;37240;92,83
3525805;Júlio Mesquita;2025;4516;213;4729;95,5
3525854;Jumirim;2025;2423;1070;3493;69,37
3525904;Jundiaí;2025;408636;10644;419280;97,46
3526001;Junqueirópolis;2025;17786;2821;20607;86,31
3526100;Juquiá;2025;12610;6357;18967;66,48
3526209;Juquitiba;2025;27819;3483;31302;88,87
3526308;Lagoinha;2025;3561;1265;4826;73,79
3526407;Laranjal Paulista;2025;26297;2590;28887;91,03
3526506;Lavínia;2025;4087;4287;8374;48,81
3526605;Lavrinhas;2025;7041;380;7421;94,88
3526704;Leme;2025;102787;1828;104615;98,25
3526803;Lençóis Paulista;2025;66955;1167;68122;98,29
3526902;Limeira;2025;296659;6517;303176;97,85
3527009;Lindóia;2025;8064;0;8064;100
3527108;Lins;2025;75360;891;76251;98,83
3527207;Lorena;2025;86169;2048;88217;97,68
3527256;Lourdes;2025;1910;278;2188;87,29
3527306;Louveira;2025;50778;1079;51857;97,92
3527405;Lucélia;2025;18785;2599;21384;87,85
3527504;Lucianópolis;2025;1878;396;2274;82,59
3527603;Luís Antônio;2025;15005;150;15155;99,01
3527702;Luiziânia;2025;5782;273;6055;95,49
3527801;Lupércio;2025;4250;208;4458;95,33
3527900;Lutécia;2025;2219;374;2593;85,58
3528007;Macatuba;2025;16832;345;17177;97,99
3528106;Macaubal;2025;7038;656;7694;91,47
3528205;Macedônia;2025;2856;661;3517;81,21
3528304;Magda;2025;2626;406;3032;86,61
3528403;Mairinque;2025;38177;9391;47568;80,26
3528502;Mairiporã;2025;99352;6535;105887;93,83
3528601;Manduri;2025;9133;574;9707;94,09
3528700;Marabá Paulista;2025;2220;2768;4988;44,51
3528809;Maracaí;2025;12613;933;13546;93,11
3528858;Marapoama;2025;2750;252;3002;91,61
3528908;Mariápolis;2025;3508;484;3992;87,88
3529005;Marília;2025;226196;10625;236821;95,51
3529104;Marinópolis;2025;1752;339;2091;83,79
3529203;Martinópolis;2025;23114;3102;26216;88,17
3529302;Matão;2025;79309;1482;80791;98,17
3529401;Mauá;2025;476394;0;476394;100
3529500;Mendonça;2025;4591;583;5174;88,73
3529609;Meridiano;2025;2712;959;3671;73,88
3529658;Mesópolis;2025;1686;211;1897;88,88
3529708;Miguelópolis;2025;20931;876;21807;95,98
3529807;Mineiros do Tietê;2025;12246;573;12819;95,53
3529906;Miracatu;2025;11099;8973;20072;55,3
3530003;Mira Estrela;2025;1992;994;2986;66,71
3530102;Mirandópolis;2025;26747;2239;28986;92,28
3530201;Mirante do Paranapanema;2025;10649;7435;18084;58,89
3530300;Mirassol;2025;57778;1498;59276;97,47
3530409;Mirassolândia;2025;3964;912;4876;81,3
3530508;Mococa;2025;63854;2727;66581;95,9
3530607;Mogi das Cruzes;2025;421608;31564;453172;93,03
3530706;Mogi-Guaçu;2025;146499;5591;152090;96,32
3530805;Moji Mirim;2025;88250;3277;91527;96,42
3530904;Mombuca;2025;3050;313;3363;90,69
3531001;Monções;2025;1902;265;2167;87,77
3531100;Mongaguá;2025;57453;252;57705;99,56
3531209;Monte Alegre do Sul;2025;5157;2809;7966;64,74
3531308;Monte Alto;2025;47463;1264;48727;97,41
3531407;Monte Aprazível;2025;22363;1613;23976;93,27
3531506;Monte Azul Paulista;2025;17156;736;17892;95,89
3531605;Monte Castelo;2025;3384;574;3958;85,5
3531704;Monteiro Lobato;2025;2069;2525;4594;45,04
3531803;Monte Mor;2025;61943;2532;64475;96,07
3531902;Morro Agudo;2025;33006;702;33708;97,92
3532009;Morungaba;2025;12688;1128;13816;91,84
3532058;Motuca;2025;3957;818;4775;82,87
3532108;Murutinga do Sul;2025;2640;1655;4295;61,47
3532157;Nantes;2025;3128;105;3233;96,75
3532207;Narandiba;2025;4306;777;5083;84,71
3532306;Natividade da Serra;2025;2880;3845;6725;42,83
3532405;Nazaré Paulista;2025;18844;444;19288;97,7
3532504;Neves Paulista;2025;7852;631;8483;92,56
3532603;Nhandeara;2025;9099;1574;10673;85,25
3532702;Nipoã;2025;4755;445;5200;91,44
3532801;Nova Aliança;2025;5899;736;6635;88,91
3532827;Nova Campina;2025;8582;1666;10248;83,74
3532843;Nova Canaã Paulista;2025;1021;838;1859;54,92
3532868;Nova Castilho;2025;1012;184;1196;84,62
3532900;Nova Europa;2025;10830;501;11331;95,58
3533007;Nova Granada;2025;20269;1338;21607;93,81
3533106;Nova Guataporanga;2025;1999;195;2194;91,11
3533205;Nova Independência;2025;3447;508;3955;87,16
3533254;Novais;2025;5472;374;5846;93,6
3533304;Nova Lusitânia;2025;4022;223;4245;94,75
3533403;Nova Odessa;2025;59346;983;60329;98,37
3533502;Novo Horizonte;2025;37370;2442;39812;93,87
3533601;Nuporanga;2025;7146;265;7411;96,42
3533700;Ocauçu;2025;3664;469;4133;88,65
3533809;Óleo;2025;1850;629;2479;74,63
3533908;Olímpia;2025;51078;2217;53295;95,84
3534005;Onda Verde;2025;3802;548;4350;87,4
3534104;Oriente;2025;6021;296;6317;95,31
3534203;Orindiúva;2025;6828;470;7298;93,56
3534302;Orlândia;2025;42008;1111;43119;97,42
3534401;Osasco;2025;690581;0;690581;100
3534500;Oscar Bressane;2025;2219;264;2483;89,37
3534609;Osvaldo Cruz;2025;28703;2530;31233;91,9
3534708;Ourinhos;2025;110342;2925;113267;97,42
3534757;Ouroeste;2025;9598;654;10252;93,62
3534807;Ouro Verde;2025;8031;430;8461;94,92
3534906;Pacaembu;2025;9562;3416;12978;73,68
3535002;Palestina;2025;10864;1601;12465;87,16
3535101;Palmares Paulista;2025;13406;398;13804;97,12
3535200;Palmeira d'Oeste;2025;7473;1472;8945;83,54
3535309;Palmital;2025;20580;1068;21648;95,07
3535408;Panorama;2025;15146;323;15469;97,91
3535507;Paraguaçu Paulista;2025;40625;4203;44828;90,62
3535606;Paraibuna;2025;5608;12994;18602;30,15
3535705;Paraíso;2025;5874;516;6390;91,92
3535804;Paranapanema;2025;18420;2505;20925;88,03
3535903;Paranapuã;2025;3611;296;3907;92,42
3536000;Parapuã;2025;9076;1265;10341;87,77
3536109;Pardinho;2025;6206;567;6773;91,63
3536208;Pariquera-Açu;2025;14015;5541;19556;71,67
3536257;Parisi;2025;1741;309;2050;84,93
3536307;Patrocínio Paulista;2025;13136;1981;15117;86,9
3536406;Paulicéia;2025;6831;659;7490;91,2
3536505;Paulínia;2025;113942;106;114048;99,91
3536570;Paulistânia;2025;1447;320;1767;81,89
3536604;Paulo de Faria;2025;7851;664;8515;92,2
3536703;Pederneiras;2025;43824;3299;47123;93
3536802;Pedra Bela;2025;1847;4171;6018;30,69
3536901;Pedranópolis;2025;1537;836;2373;64,77
3537008;Pedregulho;2025;12403;4078;16481;75,26
3537107;Pedreira;2025;47971;406;48377;99,16
3537156;Pedrinhas Paulista;2025;2676;357;3033;88,23
3537206;Pedro de Toledo;2025;8133;3238;11371;71,52
3537305;Penápolis;2025;59735;1682;61417;97,26
3537404;Pereira Barreto;2025;23933;1558;25491;93,89
3537503;Pereiras;2025;5897;2933;8830;66,78
3537602;Peruíbe;2025;68661;315;68976;99,54
3537701;Piacatu;2025;5718;404;6122;93,4
3537800;Piedade;2025;25952;28190;54142;47,93
3537909;Pilar do Sul;2025;24625;4269;28894;85,23
3538006;Pindamonhangaba;2025;165171;4228;169399;97,5
3538105;Pindorama;2025;15749;889;16638;94,66
3538204;Pinhalzinho;2025;7825;7549;15374;50,9
3538303;Piquerobi;2025;2872;648;3520;81,59
3538501;Piquete;2025;12693;824;13517;93,9
3538600;Piracaia;2025;26750;0;26750;100
3538709;Piracicaba;2025;390870;7026;397896;98,23
3538808;Piraju;2025;26479;1983;28462;93,03
3538907;Pirajuí;2025;19201;4138;23339;82,27
3539004;Pirangi;2025;10057;780;10837;92,8
3539103;Pirapora do Bom Jesus;2025;20333;0;20333;100
3539202;Pirapozinho;2025;27231;1057;28288;96,26
3539301;Pirassununga;2025;70633;4154;74787;94,45
3539400;Piratininga;2025;12091;1589;13680;88,38
3539509;Pitangueiras;2025;39130;816;39946;97,96
3539608;Planalto;2025;4907;537;5444;90,14
3539707;Platina;2025;3066;570;3636;84,32
3539806;Poá;2025;117457;1886;119343;98,42
3539905;Poloni;2025;5106;631;5737;89
3540002;Pompéia;2025;20498;1299;21797;94,04
3540101;Pongaí;2025;2955;341;3296;89,65
3540200;Pontal;2025;51982;407;52389;99,22
3540259;Pontalinda;2025;4123;503;4626;89,13
3540309;Pontes Gestal;2025;2294;244;2538;90,39
3540408;Populina;2025;3324;579;3903;85,17
3540507;Porangaba;2025;4667;5000;9667;48,28
3540606;Porto Feliz;2025;46628;6130;52758;88,38
3540705;Porto Ferreira;2025;53981;986;54967;98,21
3540754;Potim;2025;16135;5142;21277;75,83
3540804;Potirendaba;2025;15715;1253;16968;92,62
3540853;Pracinha;2025;1410;1534;2944;47,89
3540903;Pradópolis;2025;20807;1429;22236;93,57
3541000;Praia Grande;2025;338217;0;338217;100
3541059;Pratânia;2025;4562;873;5435;83,94
3541109;Presidente Alves;2025;3570;404;3974;89,83
3541208;Presidente Bernardes;2025;11790;1892;13682;86,17
3541307;Presidente Epitácio;2025;40363;2458;42821;94,26
3541406;Presidente Prudente;2025;220834;4599;225433;97,96
3541505;Presidente Venceslau;2025;36889;1000;37889;97,36
3541604;Promissão;2025;35889;5478;41367;86,76
3541653;Quadra;2025;1014;2878;3892;26,05
3541703;Quatá;2025;13702;690;14392;95,21
3541802;Queiroz;2025;3188;296;3484;91,5
3541901;Queluz;2025;10749;2357;13106;82,02
3542008;Quitana;2025;6219;480;6699;92,83
3542107;Rafard;2025;8339;827;9166;90,98
3542206;Rancharia;2025;26774;2111;28885;92,69
3542305;Redenção da Serra;2025;2991;827;3818;78,34
3542404;Regente Feijó;2025;18740;1077;19817;94,57
3542503;Reginópolis;2025;4263;2894;7157;59,56
3542602;Registro;2025;48369;6117;54486;88,77
3542701;Restinga;2025;6652;1258;7910;84,1
3542800;Ribeira;2025;1625;1604;3229;50,33
3542909;Ribeirão Bonito;2025;12706;623;13329;95,33
3543006;Ribeirão Branco;2025;11200;6471;17671;63,38
3543105;Ribeirão Corrente;2025;4075;764;4839;84,21
3543204;Ribeirão do Sul;2025;3659;654;4313;84,84
3543238;Ribeirão dos Índios;2025;1906;207;2113;90,2
3543253;Ribeirão Grande;2025;2394;5142;7536;31,77
3543303;Ribeirão Pires;2025;120838;0;120838;100
3543402;Ribeirão Preto;2025;707723;2014;709737;99,72
3543501;Riversul;2025;4303;1306;5609;76,72
3543600;Rifaina;2025;3106;371;3477;89,33
3543709;Rincão;2025;8759;1789;10548;83,04
3543808;Rinópolis;2025;8944;677;9621;92,96
3543907;Rio Claro;2025;202336;4325;206661;97,91
3544004;Rio das Pedras;2025;35502;707;36209;98,05
3544103;Rio Grande da Serra;2025;52351;0;52351;100
3544202;Riolândia;2025;9329;2463;11792;79,11
3544251;Rosana;2025;17602;449;18051;97,51
3544301;Roseira;2025;10649;401;11050;96,37
3544400;Rubiácea;2025;2014;1251;3265;61,68
3544509;Rubinéia;2025;2704;320;3024;89,42
3544608;Sabino;2025;5145;410;5555;92,62
3544707;Sagres;2025;2061;301;2362;87,26
3544806;Sales;2025;5813;402;6215;93,53
3544905;Sales Oliveira;2025;11277;552;11829;95,33
3545001;Salesópolis;2025;11760;5622;17382;67,66
3545100;Salmourão;2025;4985;240;5225;95,41
3545159;Saltinho;2025;6771;1278;8049;84,12
3545209;Salto;2025;118163;837;119000;99,3
3545308;Salto de Pirapora;2025;36076;9665;45741;78,87
3545407;Salto Grande;2025;8578;664;9242;92,82
3545506;Sandovalina;2025;3734;713;4447;83,97
3545605;Santa Adélia;2025;14265;813;15078;94,61
3545704;Santa Albertina;2025;5060;538;5598;90,39
3545803;Santa Bárbara d'Oeste;2025;190186;1505;191691;99,21
3546009;Santa Branca;2025;12652;1692;14344;88,2
3546108;Santa Clara d'Oeste;2025;1624;343;1967;82,56
3546207;Santa Cruz da Conceição;2025;3672;791;4463;82,28
3546256;Santa Cruz da Esperança;2025;1474;652;2126;69,33
3546306;Santa Cruz das Palmeiras;2025;34571;696;35267;98,03
3546405;Santa Cruz do Rio Pardo;2025;44344;2601;46945;94,46
3546504;Santa Ernestina;2025;5357;180;5537;96,75
3546603;Santa Fé do Sul;2025;30038;1231;31269;96,06
3546702;Santa Gertrudes;2025;27863;299;28162;98,94
3546801;Santa Isabel;2025;46860;9995;56855;82,42
3546900;Santa Lucia;2025;8382;319;8701;96,33
3547007;Santa Maria da Serra;2025;5965;517;6482;92,02
3547106;Santa Mercedes;2025;2620;197;2817;93,01
3547205;Santana da Ponte Pensa;2025;1117;334;1451;76,98
3547304;Santana de Parnaíba;2025;151005;0;151005;100
3547403;Santa Rita d'Oeste;2025;1913;414;2327;82,21
3547502;Santa Rita do Passa Quatro;2025;24371;1867;26238;92,88
3547601;Santa Rosa do Viterbo;2025;25358;893;26251;96,6
3547650;Santa Salete;2025;1106;324;1430;77,34
3547700;Santo Anastácio;2025;18969;1054;20023;94,74
3547809;Santo André;2025;697947;0;697947;100
3547908;Santo Antonio da Alegria;2025;5131;1626;6757;75,94
3548005;Santo Antonio da Posse;2025;22953;797;23750;96,64
3548054;Santo Antonio do Aracanguá;2025;7621;858;8479;89,88
3548104;Santo Antonio do Jardim;2025;3959;1853;5812;68,12
3548203;Santo Antonio do Pinhal;2025;4989;1716;6705;74,41
3548302;Santo Expedito;2025;2881;158;3039;94,8
3548401;Santópolis do Aguapeí;2025;4711;107;4818;97,78
3548500;Santos;2025;432445;324;432769;99,93
3548609;São Bento do Sapucaí;2025;5640;4933;10573;53,34
3548708;São Bernardo do Campo;2025;814267;13053;827320;98,42
3548807;São Caetano do Sul;2025;150581;0;150581;100
3548906;São Carlos;2025;239732;10002;249734;95,99
3549003;São Francisco;2025;2206;421;2627;83,97
3549102;São João da Boa Vista;2025;86302;2024;88326;97,71
3549201;São João das Duas Pontes;2025;1875;548;2423;77,38
3549250;São João de Iracema;2025;1710;154;1864;91,74
3549300;São João do Pau d'Alho;2025;1708;221;1929;88,54
3549409;São Joaquim da Barra;2025;50777;910;51687;98,24
3549508;São José da Bela Vista;2025;8203;701;8904;92,13
3549607;São José do Barreiro;2025;3370;713;4083;82,54
3549706;São José do Rio Pardo;2025;50065;3499;53564;93,47
3549805;São José do Rio Preto;2025;432315;27921;460236;93,93
3549904;São José dos Campos;2025;726258;15082;741340;97,97
3549953;São Lourenço da Serra;2025;15310;996;16306;93,89
3550001;São Luís do Paraitinga;2025;6408;4234;10642;60,21
3550100;São Manuel;2025;39629;471;40100;98,83
3550209;São Miguel Arcanjo;2025;26187;6395;32582;80,37
3550308;São Paulo;2025;11988615;108745;12097360;99,1
3550407;São Pedro;2025;31098;4119;35217;88,3
3550506;São Pedro do Turvo;2025;6014;1455;7469;80,52
3550605;São Roque;2025;88481;1982;90463;97,81
3550704;São Sebastião;2025;91319;1040;92359;98,87
3550803;São Sebastião da Grama;2025;8750;3149;11899;73,54
3550902;São Simão;2025;14056;1015;15071;93,27
3551009;São Vicente;2025;369054;698;369752;99,81
3551108;Sarapuí;2025;8827;1776;10603;83,25
3551207;Sarutaiá;2025;3244;430;3674;88,3
3551306;Sebastianópolis do Sul;2025;2943;407;3350;87,85
3551405;Serra Azul;2025;9111;3681;12792;71,22
3551504;Serrana;2025;46445;211;46656;99,55
3551603;Serra Negra;2025;24145;3528;27673;87,25
3551702;Sertãozinho;2025;125901;471;126372;99,63
3551801;Sete Barras;2025;9906;2795;12701;77,99
3551900;Severínia;2025;17253;570;17823;96,8
3552007;Silveiras;2025;3566;2817;6383;55,87
3552106;Socorro;2025;28835;10517;39352;73,27
3552205;Sorocaba;2025;677952;6970;684922;98,98
3552304;Sud Mennucci;2025;6720;1072;7792;86,24
3552403;Sumaré;2025;296312;3530;299842;98,82
3552502;Suzano;2025;292838;10685;303523;96,48
3552551;Suzanópolis;2025;2780;1385;4165;66,75
3552601;Tabapuã;2025;11281;740;12021;93,84
3552700;Tabatinga;2025;15077;1319;16396;91,96
3552809;Taboão da Serra;2025;300673;0;300673;100
3552908;Taciba;2025;5517;673;6190;89,13
3553005;Taguaí;2025;10218;4046;14264;71,63
3553104;Taiaçu;2025;5730;358;6088;94,12
3553203;Taiúva;2025;5886;329;6215;94,71
3553302;Tambaú;2025;21264;1755;23019;92,38
3553401;Tanabi;2025;23683;1633;25316;93,55
3553500;Tapiraí;2025;5938;1791;7729;76,83
3553609;Tapiratiba;2025;11558;1012;12570;91,95
3553658;Taquaral;2025;2683;82;2765;97,03
3553708;Taquaritinga;2025;52772;1888;54660;96,55
3553807;Taquarituba;2025;21684;1776;23460;92,43
3553856;Taquarivaí;2025;3610;2428;6038;59,79
3553906;Tarabaí;2025;7155;406;7561;94,63
3553955;Tarumã;2025;14822;722;15544;95,36
3554003;Tatuí;2025;122725;2891;125616;97,7
3554102;Taubaté;2025;311643;6474;318117;97,96
3554201;Tejupá;2025;3852;896;4748;81,13
3554300;Teodoro Sampaio;2025;19030;3791;22821;83,39
3554409;Terra Roxa;2025;9042;329;9371;96,49
3554508;Tietê;2025;39162;3597;42759;91,59
3554607;Timburi;2025;2028;497;2525;80,32
3554656;Torre de Pedra;2025;1733;612;2345;73,9
3554706;Torrinha;2025;8681;1149;9830;88,31
3554755;Trabiju;2025;1669;100;1769;94,35
3554805;Tremembé;2025;45099;2853;47952;94,05
3554904;Três Fronteiras;2025;4991;569;5560;89,77
3554953;Tuiuti;2025;3811;2948;6759;56,38
3555000;Tupã;2025;59738;2496;62234;95,99
3555109;Tupi Paulista;2025;11691;3195;14886;78,54
3555208;Turiúba;2025;1612;266;1878;85,84
3555307;Turmalina;2025;1351;377;1728;78,18
3555356;Ubarana;2025;5910;462;6372;92,75
3555406;Ubatuba;2025;91184;2148;93332;97,7
3555505;Ubirajara;2025;3535;1232;4767;74,16
3555604;Uchôa;2025;9121;595;9716;93,88
3555703;União Paulista;2025;1478;323;1801;82,07
3555802;Urânia;2025;7485;991;8476;88,31
3555901;Uru;2025;1137;52;1189;95,63
3556008;Urupês;2025;12268;983;13251;92,58
3556107;Valentim Gentil;2025;12514;904;13418;93,26
3556206;Valinhos;2025;124702;5419;130121;95,84
3556305;Valparaíso;2025;23985;560;24545;97,72
3556354;Vargem;2025;7192;3282;10474;68,67
3556404;Vargem Grande do Sul;2025;41010;1413;42423;96,67
3556453;Vargem Grande Paulista;2025;57156;0;57156;100
3556503;Várzea Paulista;2025;125345;0;125345;100
3556602;Vera Cruz;2025;9491;941;10432;90,98
3556701;Vinhedo;2025;79645;2584;82229;96,86
3556800;Viradouro;2025;18171;548;18719;97,07
3556909;Vista Alegre do Alto;2025;8023;381;8404;95,47
3556958;Vitória Brasil;2025;1594;167;1761;90,52
3557006;Votorantim;2025;119343;4732;124075;96,19
3557105;Votuporanga;2025;91315;2632;93947;97,2
3557154;Zacarias;2025;2302;329;2631;87,5
3557204;Chavantes;2025;11615;637;12252;94,8
3557303;Estiva Gerbi;2025;9151;2322;11473;79,76
3500105;Adamantina;2030;32556;923;33479;97,24
3500204;Adolfo;2030;3102;218;3320;93,43
3500303;Aguaí;2030;35718;2387;38105;93,74
3500402;Águas da Prata;2030;7377;455;7832;94,19
3500501;Águas de Lindóia;2030;18708;169;18877;99,1
3500550;Águas de Santa Bárbara;2030;4879;1268;6147;79,37
3500600;Águas de São Pedro;2030;3292;0;3292;100
3500709;Agudos;2030;35941;1144;37085;96,92
3500758;Alambari;2030;5645;849;6494;86,93
3500808;Alfredo Marcondes;2030;3642;223;3865;94,23
3500907;Altair;2030;3681;480;4161;88,46
3501004;Altinópolis;2030;14608;820;15428;94,68
3501103;Alto Alegre;2030;3483;416;3899;89,33
3501152;Alumínio;2030;15832;3045;18877;83,87
3501202;Álvares Florence;2030;2621;730;3351;78,22
3501301;Álvares Machado;2030;22194;1841;24035;92,34
3501400;Álvaro de Carvalho;2030;3817;1557;5374;71,03
3501509;Alvinlândia;2030;3089;210;3299;93,63
3501608;Americana;2030;245410;1152;246562;99,53
3501707;Américo Brasiliense;2030;43793;334;44127;99,24
3501806;Américo de Campos;2030;5079;564;5643;90,01
3501905;Amparo;2030;62841;8315;71156;88,31
3502002;Analândia;2030;4594;665;5259;87,36
3502101;Andradina;2030;53334;2769;56103;95,06
3502200;Angatuba;2030;20378;5886;26264;77,59
3502309;Anhembi;2030;6079;1366;7445;81,65
3502408;Anhumas;2030;3784;346;4130;91,62
3502507;Aparecida;2030;35292;521;35813;98,55
3502606;Aparecida d'Oeste;2030;3460;390;3850;89,87
3502705;Apiaí;2030;22010;3173;25183;87,4
3502754;Araçariguama;2030;23850;0;23850;100
3502804;Araçatuba;2030;189620;3729;193349;98,07
3502903;Araçoiaba da Serra;2030;25110;11422;36532;68,73
3503000;Aramina;2030;5504;143;5647;97,47
3503109;Arandu;2030;5446;755;6201;87,82
3503158;Arapeí;2030;1956;490;2446;79,97
3503208;Araraquara;2030;229752;6723;236475;97,16
3503307;Araras;2030;132282;5942;138224;95,7
3503356;Arco-Íris;2030;1206;504;1710;70,53
3503406;Arealva;2030;7365;1020;8385;87,84
3503505;Areias;2030;2693;1323;4016;67,06
3503604;Areiópolis;2030;10714;550;11264;95,12
3503703;Ariranha;2030;9289;520;9809;94,7
3503802;Artur Nogueira;2030;52780;5514;58294;90,54
3503901;Arujá;2030;97692;3465;101157;96,57
3503950;Aspásia;2030;1358;353;1711;79,37
3504008;Assis;2030;100420;4583;105003;95,64
3504107;Atibaia;2030;141294;6854;148148;95,37
3504206;Auriflama;2030;13693;729;14422;94,95
3504305;Avaí;2030;3700;1810;5510;67,15
3504404;Avanhandava;2030;10805;1974;12779;84,55
3504503;Avaré;2030;87498;2564;90062;97,15
3504602;Bady Bassitt;2030;16143;1043;17186;93,93
3504701;Balbinos;2030;1195;2521;3716;32,16
3504800;Bálsamo;2030;8087;541;8628;93,73
3504909;Bananal;2030;9686;1315;11001;88,05
3505005;Barão de Antonina;2030;2378;1224;3602;66,02
3505104;Barbosa;2030;6783;1063;7846;86,45
3505203;Bariri;2030;34534;983;35517;97,23
3505302;Barra Bonita;2030;33659;599;34258;98,25
3505351;Barra do Chapéu;2030;1715;4111;5826;29,44
3505401;Barra do Turvo;2030;4138;3774;7912;52,3
3505500;Barretos;2030;117069;3678;120747;96,95
3505609;Barrinha;2030;34901;391;35292;98,89
3505708;Barueri;2030;281110;0;281110;100
3505807;Bastos;2030;18325;1909;20234;90,57
3505906;Batatais;2030;55315;7233;62548;88,44
3506003;Bauru;2030;367767;6256;374023;98,33
3506102;Bebedouro;2030;69609;2468;72077;96,58
3506201;Bento de Abreu;2030;3043;88;3131;97,19
3506300;Bernardino de Campos;2030;10016;779;10795;92,78
3506359;Bertioga;2030;74923;417;75340;99,45
3506409;Bilac;2030;7767;340;8107;95,81
3506508;Birigui;2030;125140;3091;128231;97,59
3506607;Biritiba Mirim;2030;31484;4087;35571;88,51
3506706;Boa Esperança do Sul;2030;14304;962;15266;93,7
3506805;Bocaina;2030;12368;720;13088;94,5
3506904;Bofete;2030;7728;4393;12121;63,76
3507001;Boituva;2030;59676;3763;63439;94,07
3507100;Bom Jesus dos Perdões;2030;25478;1868;27346;93,17
3507159;Bom Sucesso de Itararé;2030;3367;823;4190;80,36
3507209;Borá;2030;631;179;810;77,9
3507308;Boracéia;2030;4709;380;5089;92,53
3507407;Borborema;2030;14992;661;15653;95,78
3507456;Borebi;2030;2679;114;2793;95,92
3507506;Botucatu;2030;144763;4624;149387;96,9
3507605;Bragança Paulista;2030;171621;3044;174665;98,26
3507704;Braúna;2030;5659;267;5926;95,49
3507753;Brejo Alegre;2030;2554;317;2871;88,96
3507803;Brodowski;2030;25439;181;25620;99,29
3507902;Brotas;2030;22397;3156;25553;87,65
3508009;Buri;2030;18210;2924;21134;86,16
3508108;Buritama;2030;16629;532;17161;96,9
3508207;Buritizal;2030;3804;627;4431;85,85
3508306;Cabrália Paulista;2030;3767;514;4281;87,99
3508405;Cabreúva;2030;51849;4012;55861;92,82
3508504;Caçapava;2030;81054;13675;94729;85,56
3508603;Cachoeira Paulista;2030;28474;4973;33447;85,13
3508702;Caconde;2030;14372;4758;19130;75,13
3508801;Cafelândia;2030;16266;1336;17602;92,41
3508900;Caiabu;2030;3639;468;4107;88,6
3509007;Caieiras;2030;109584;1492;111076;98,66
3509106;Caiuá;2030;2289;3687;5976;38,3
3509205;Cajamar;2030;88080;860;88940;99,03
3509254;Cajati;2030;22843;7527;30370;75,22
3509304;Cajobi;2030;9797;431;10228;95,79
3509403;Cajuru;2030;24508;2795;27303;89,76
3509452;Campina do Monte Alegre;2030;5421;549;5970;90,8
3509502;Campinas;2030;1202357;21037;1223394;98,28
3509601;Campo Limpo Paulista;2030;88915;0;88915;100
3509700;Campos do Jordão;2030;51332;322;51654;99,38
3509809;Campos Novos Paulista;2030;4355;687;5042;86,37
3509908;Cananéia;2030;11195;1581;12776;87,63
3509957;Canas;2030;5428;148;5576;97,35
3510005;Cândido Mota;2030;28328;1373;29701;95,38
3510104;Cândido Rodrigues;2030;2336;288;2624;89,02
3510153;Canitar;2030;5292;249;5541;95,51
3510203;Capão Bonito;2030;41483;5860;47343;87,62
3510302;Capela do Alto;2030;20892;2374;23266;89,8
3510401;Capivari;2030;57251;1081;58332;98,15
3510500;Caraguatatuba;2030;120976;4232;125208;96,62
3510609;Carapicuíba;2030;412095;0;412095;100
3510708;Cardoso;2030;10717;846;11563;92,68
3510807;Casa Branca;2030;25275;4881;30156;83,81
3510906;Cássia dos Coqueiros;2030;2019;395;2414;83,64
3511003;Castilho;2030;17075;5551;22626;75,47
3511102;Catanduva;2030;117314;950;118264;99,2
3511201;Catiguá;2030;7235;499;7734;93,55
3511300;Cedral;2030;7986;1319;9305;85,82
3511409;Cerqueira César;2030;19246;1202;20448;94,12
3511508;Cerquilho;2030;48538;2649;51187;94,82
3511607;Cesário Lange;2030;12299;5917;18216;67,52
3511706;Charqueada;2030;16791;1426;18217;92,17
3511904;Clementina;2030;8943;222;9165;97,58
3512001;Colina;2030;16866;662;17528;96,22
3512100;Colômbia;2030;4682;1343;6025;77,71
3512209;Conchal;2030;28084;683;28767;97,63
3512308;Conchas;2030;15751;1987;17738;88,8
3512407;Cordeirópolis;2030;24035;2724;26759;89,82
3512506;Coroados;2030;5627;673;6300;89,32
3512605;Coronel Macedo;2030;4113;682;4795;85,78
3512704;Corumbataí;2030;2828;1204;4032;70,14
3512803;Cosmópolis;2030;74377;5708;80085;92,87
3512902;Cosmorama;2030;5581;1175;6756;82,61
3513009;Cotia;2030;285614;0;285614;100
3513108;Cravinhos;2030;35860;335;36195;99,07
3513207;Cristais Paulista;2030;8066;947;9013;89,49
3513306;Cruzália;2030;1515;492;2007;75,49
3513405;Cruzeiro;2030;79759;1747;81506;97,86
3513504;Cubatão;2030;137235;0;137235;100
3513603;Cunha;2030;14845;6573;21418;69,31
3513702;Descalvado;2030;31274;1752;33026;94,7
3513801;Diadema;2030;414532;0;414532;100
3513850;Dirce Reis;2030;1469;219;1688;87,03
3513900;Divinolândia;2030;8729;1928;10657;81,91
3514007;Dobrada;2030;9421;215;9636;97,77
3514106;Dois Córregos;2030;27953;656;28609;97,71
3514205;Dolcinópolis;2030;1844;119;1963;93,94
3514304;Dourado;2030;7609;662;8271;92
3514403;Dracena;2030;42556;3009;45565;93,4
3514502;Duartina;2030;10923;695;11618;94,02
3514601;Dumont;2030;10245;107;10352;98,97
3514700;Echaporã;2030;5212;896;6108;85,33
3514809;Eldorado;2030;7936;8191;16127;49,21
3514908;Elias Fausto;2030;16129;2237;18366;87,82
3514924;Elisiário;2030;3410;226;3636;93,78
3514957;Embaúba;2030;2171;204;2375;91,41
3515004;Embu;2030;293664;0;293664;100
3515103;Embu-Guaçu;2030;70828;1941;72769;97,33
3515129;Emilianópolis;2030;2779;266;3045;91,26
3515152;Engenheiro Coelho;2030;18731;5006;23737;78,91
3515186;Espírito Santo do Pinhal;2030;39910;2995;42905;93,02
3515194;Espírito Santo do Turvo;2030;4510;763;5273;85,53
3515202;Estrela d'Oeste;2030;7122;810;7932;89,79
3515301;Estrela do Norte;2030;2457;232;2689;91,37
3515350;Euclides da Cunha Paulista;2030;6318;3355;9673;65,32
3515400;Fartura;2030;13756;2174;15930;86,35
3515509;Fernandópolis;2030;63792;2016;65808;96,94
3515608;Fernando Prestes;2030;5151;349;5500;93,65
3515657;Fernão;2030;1156;557;1713;67,48
3515707;Ferraz de Vasconcelos;2030;203197;9546;212743;95,51
3515806;Flora Rica;2030;1341;126;1467;91,41
3515905;Floreal;2030;2362;341;2703;87,38
3516002;Flórida Paulista;2030;9088;2430;11518;78,9
3516101;Florínia;2030;2451;178;2629;93,23
3516200;Franca;2030;349826;6251;356077;98,24
3516309;Francisco Morato;2030;193053;393;193446;99,8
3516408;Franco da Rocha;2030;154873;13234;168107;92,13
3516507;Gabriel Monteiro;2030;2406;195;2601;92,5
3516606;Gália;2030;5054;1247;6301;80,21
3516705;Garça;2030;39176;2143;41319;94,81
3516804;Gastão Vidigal;2030;4954;207;5161;95,99
3516853;Gavião Peixoto;2030;4441;307;4748;93,53
3516903;General Salgado;2030;9491;931;10422;91,07
3517000;Getulina;2030;9259;1643;10902;84,93
3517109;Glicério;2030;3883;965;4848;80,09
3517208;Guaiçara;2030;12152;667;12819;94,8
3517307;Guaimbê;2030;5312;356;5668;93,72
3517406;Guaíra;2030;38471;1213;39684;96,94
3517505;Guapiaçu;2030;20890;1760;22650;92,23
3517604;Guapiara;2030;8100;10220;18320;44,21
3517703;Guará;2030;21212;438;21650;97,98
3517802;Guaraçai;2030;7020;1244;8264;84,95
3517901;Guaraci;2030;10998;602;11600;94,81
3518008;Guarani d'Oeste;2030;1697;180;1877;90,41
3518107;Guarantã;2030;6156;385;6541;94,11
3518206;Guararapes;2030;31079;1598;32677;95,11
3518305;Guararema;2030;27771;4500;32271;86,06
3518404;Guaratinguetá;2030;115818;5486;121304;95,48
3518503;Guareí;2030;9565;6995;16560;57,76
3518602;Guariba;2030;40820;501;41321;98,79
3518701;Guarujá;2030;337788;65;337853;99,98
3518800;Guarulhos;2030;1448031;0;1448031;100
3518859;Guatapará;2030;6699;1102;7801;85,87
3518909;Guzolândia;2030;4925;417;5342;92,19
3519006;Herculândia;2030;9219;512;9731;94,74
3519055;Holambra;2030;15173;1363;16536;91,76
3519071;Hortolândia;2030;260650;0;260650;100
3519105;Iacanga;2030;10974;1218;12192;90,01
3519204;Iacri;2030;5378;701;6079;88,47
3519253;Iaras;2030;3274;4085;7359;44,49
3519303;Ibaté;2030;36333;1175;37508;96,87
3519402;Ibirá;2030;11867;785;12652;93,8
3519501;Ibirarema;2030;7640;425;8065;94,73
3519600;Ibitinga;2030;59568;1831;61399;97,02
3519709;Ibiúna;2030;31164;49114;80278;38,82
3519808;Icém;2030;7369;1056;8425;87,47
3519907;Iepê;2030;7719;393;8112;95,16
3520004;Igaraçu do Tietê;2030;24583;142;24725;99,43
3520103;Igarapava;2030;29179;1127;30306;96,28
3520202;Igaratá;2030;8712;971;9683;89,97
3520301;Iguape;2030;26787;3515;30302;88,4
3520400;Ilhabela;2030;36402;252;36654;99,31
3520426;Ilha Comprida;2030;11358;0;11358;100
3520442;Ilha Solteira;2030;24027;1577;25604;93,84
3520509;Indaiatuba;2030;261935;2660;264595;98,99
3520608;Indiana;2030;4252;458;4710;90,28
3520707;Indiaporã;2030;3480;284;3764;92,45
3520806;Inúbia Paulista;2030;3775;290;4065;92,87
3520905;Ipaussu;2030;14391;774;15165;94,9
3521002;Iperó;2030;23711;14715;38426;61,71
3521101;Ipeúna;2030;8329;574;8903;93,55
3521150;Ipiguá;2030;3895;1781;5676;68,62
3521200;Iporanga;2030;3406;1183;4589;74,22
3521309;Ipuã;2030;16644;447;17091;97,38
3521408;Iracemápolis;2030;25510;447;25957;98,28
3521507;Irapuã;2030;7463;534;7997;93,32
3521606;Irapuru;2030;4914;2036;6950;70,71
3521705;Itaberá;2030;14540;3109;17649;82,38
3521804;Itaí;2030;22336;6109;28445;78,52
3521903;Itajobi;2030;13001;1364;14365;90,5
3522000;Itaju;2030;3435;514;3949;86,98
3522109;Itanhaém;2030;107086;647;107733;99,4
3522158;Itaóca;2030;1747;1457;3204;54,53
3522208;Itapecerica da Serra;2030;182146;1522;183668;99,17
3522307;Itapetininga;2030;160562;11896;172458;93,1
3522406;Itapeva;2030;90826;5014;95840;94,77
3522505;Itapevi;2030;270639;0;270639;100
3522604;Itapira;2030;68063;3917;71980;94,56
3522653;Itapirapuã Paulista;2030;2424;2071;4495;53,93
3522703;Itápolis;2030;40319;1932;42251;95,43
3522802;Itaporanga;2030;12763;2109;14872;85,82
3522901;Itapuí;2030;14656;341;14997;97,73
3523008;Itapura;2030;4301;1081;5382;79,91
3523107;Itaquaquecetuba;2030;412303;0;412303;100
3523206;Itararé;2030;46766;3463;50229;93,11
3523305;Itariri;2030;14524;4340;18864;76,99
3523404;Itatiba;2030;114177;13592;127769;89,36
3523503;Itatinga;2030;21386;1101;22487;95,1
3523602;Itirapina;2030;17193;1065;18258;94,17
3523701;Itirapuã;2030;5842;730;6572;88,89
3523800;Itobi;2030;7272;292;7564;96,14
3523909;Itu;2030;172872;6856;179728;96,19
3524006;Itupeva;2030;67175;2566;69741;96,32
3524105;Ituverava;2030;38441;2390;40831;94,15
3524204;Jaborandi;2030;6388;281;6669;95,79
3524303;Jaboticabal;2030;74156;781;74937;98,96
3524402;Jacareí;2030;234985;3291;238276;98,62
3524501;Jaci;2030;7167;526;7693;93,16
3524600;Jacupiranga;2030;9492;7941;17433;54,45
3524709;Jaguariúna;2030;59513;1048;60561;98,27
3524808;Jales;2030;43996;2758;46754;94,1
3524907;Jambeiro;2030;3222;3508;6730;47,88
3525003;Jandira;2030;136231;0;136231;100
3525102;Jardinópolis;2030;45718;455;46173;99,01
3525201;Jarinu;2030;31775;2912;34687;91,6
3525300;Jaú;2030;153399;3269;156668;97,91
3525409;Jeriquara;2030;2830;301;3131;90,39
3525508;Joanópolis;2030;13127;0;13127;100
3525607;João Ramalho;2030;4152;390;4542;91,41
3525706;José Bonifácio;2030;35525;2603;38128;93,17
3525805;Júlio Mesquita;2030;4584;216;4800;95,5
3525854;Jumirim;2030;2649;992;3641;72,75
3525904;Jundiaí;2030;417674;9729;427403;97,72
3526001;Junqueirópolis;2030;18358;2634;20992;87,45
3526100;Juquiá;2030;12890;6192;19082;67,55
3526209;Juquitiba;2030;29349;2798;32147;91,3
3526308;Lagoinha;2030;3685;1139;4824;76,39
3526407;Laranjal Paulista;2030;27141;2528;29669;91,48
3526506;Lavínia;2030;4022;4219;8241;48,8
3526605;Lavrinhas;2030;7275;341;7616;95,52
3526704;Leme;2030;105570;1860;107430;98,27
3526803;Lençóis Paulista;2030;68164;1172;69336;98,31
3526902;Limeira;2030;301103;6205;307308;97,98
3527009;Lindóia;2030;8330;0;8330;100
3527108;Lins;2030;75792;896;76688;98,83
3527207;Lorena;2030;87281;1996;89277;97,76
3527256;Lourdes;2030;1924;245;2169;88,7
3527306;Louveira;2030;53591;1048;54639;98,08
3527405;Lucélia;2030;19012;2535;21547;88,24
3527504;Lucianópolis;2030;1894;371;2265;83,62
3527603;Luís Antônio;2030;15831;114;15945;99,29
3527702;Luiziânia;2030;6041;240;6281;96,18
3527801;Lupércio;2030;4267;203;4470;95,46
3527900;Lutécia;2030;2237;331;2568;87,11
3528007;Macatuba;2030;17014;327;17341;98,11
3528106;Macaubal;2030;6995;603;7598;92,06
3528205;Macedônia;2030;2846;597;3443;82,66
3528304;Magda;2030;2600;370;2970;87,54
3528403;Mairinque;2030;38869;9561;48430;80,26
3528502;Mairiporã;2030;106095;5466;111561;95,1
3528601;Manduri;2030;9366;446;9812;95,45
3528700;Marabá Paulista;2030;2238;2789;5027;44,52
3528809;Maracaí;2030;12645;861;13506;93,63
3528858;Marapoama;2030;2822;227;3049;92,55
3528908;Mariápolis;2030;3575;410;3985;89,71
3529005;Marília;2030;229049;10759;239808;95,51
3529104;Marinópolis;2030;1759;309;2068;85,06
3529203;Martinópolis;2030;23682;2839;26521;89,3
3529302;Matão;2030;79520;1486;81006;98,17
3529401;Mauá;2030;488538;0;488538;100
3529500;Mendonça;2030;4675;516;5191;90,06
3529609;Meridiano;2030;2709;891;3600;75,25
3529658;Mesópolis;2030;1713;178;1891;90,59
3529708;Miguelópolis;2030;21304;799;22103;96,39
3529807;Mineiros do Tietê;2030;12405;580;12985;95,53
3529906;Miracatu;2030;11483;8821;20304;56,56
3530003;Mira Estrela;2030;1998;997;2995;66,71
3530102;Mirandópolis;2030;27110;2009;29119;93,1
3530201;Mirante do Paranapanema;2030;10764;7516;18280;58,88
3530300;Mirassol;2030;58500;1516;60016;97,47
3530409;Mirassolândia;2030;4068;936;5004;81,29
3530508;Mococa;2030;63767;2278;66045;96,55
3530607;Mogi das Cruzes;2030;439030;31490;470520;93,31
3530706;Mogi-Guaçu;2030;149263;5179;154442;96,65
3530805;Moji Mirim;2030;89144;2831;91975;96,92
3530904;Mombuca;2030;3135;256;3391;92,45
3531001;Monções;2030;1897;253;2150;88,23
3531100;Mongaguá;2030;60041;263;60304;99,56
3531209;Monte Alegre do Sul;2030;5437;2666;8103;67,1
3531308;Monte Alto;2030;47583;1055;48638;97,83
3531407;Monte Aprazível;2030;22573;1561;24134;93,53
3531506;Monte Azul Paulista;2030;16883;662;17545;96,23
3531605;Monte Castelo;2030;3401;500;3901;87,18
3531704;Monteiro Lobato;2030;2139;2544;4683;45,68
3531803;Monte Mor;2030;66037;2378;68415;96,52
3531902;Morro Agudo;2030;34185;670;34855;98,08
3532009;Morungaba;2030;13284;968;14252;93,21
3532058;Motuca;2030;4160;710;4870;85,42
3532108;Murutinga do Sul;2030;2625;1645;4270;61,48
3532157;Nantes;2030;3276;90;3366;97,33
3532207;Narandiba;2030;4618;659;5277;87,51
3532306;Natividade da Serra;2030;2906;3825;6731;43,17
3532405;Nazaré Paulista;2030;19577;382;19959;98,09
3532504;Neves Paulista;2030;7712;585;8297;92,95
3532603;Nhandeara;2030;9032;1426;10458;86,36
3532702;Nipoã;2030;4938;431;5369;91,97
3532801;Nova Aliança;2030;6060;665;6725;90,11
3532827;Nova Campina;2030;9390;1362;10752;87,33
3532843;Nova Canaã Paulista;2030;1049;724;1773;59,17
3532868;Nova Castilho;2030;1064;140;1204;88,37
3532900;Nova Europa;2030;11282;465;11747;96,04
3533007;Nova Granada;2030;20737;1353;22090;93,88
3533106;Nova Guataporanga;2030;2006;171;2177;92,15
3533205;Nova Independência;2030;3670;455;4125;88,97
3533254;Novais;2030;5712;379;6091;93,78
3533304;Nova Lusitânia;2030;4215;192;4407;95,64
3533403;Nova Odessa;2030;60974;1010;61984;98,37
3533502;Novo Horizonte;2030;37775;2452;40227;93,9
3533601;Nuporanga;2030;7273;215;7488;97,13
3533700;Ocauçu;2030;3708;395;4103;90,37
3533809;Óleo;2030;1869;557;2426;77,04
3533908;Olímpia;2030;51581;2090;53671;96,11
3534005;Onda Verde;2030;3959;483;4442;89,13
3534104;Oriente;2030;6037;290;6327;95,42
3534203;Orindiúva;2030;7164;480;7644;93,72
3534302;Orlândia;2030;42471;1123;43594;97,42
3534401;Osasco;2030;697016;0;697016;100
3534500;Oscar Bressane;2030;2203;224;2427;90,77
3534609;Osvaldo Cruz;2030;28601;2330;30931;92,47
3534708;Ourinhos;2030;112187;2974;115161;97,42
3534757;Ouroeste;2030;9953;658;10611;93,8
3534807;Ouro Verde;2030;8227;384;8611;95,54
3534906;Pacaembu;2030;9490;3390;12880;73,68
3535002;Palestina;2030;11094;1491;12585;88,15
3535101;Palmares Paulista;2030;14043;417;14460;97,12
3535200;Palmeira d'Oeste;2030;7465;1278;8743;85,38
3535309;Palmital;2030;20510;1012;21522;95,3
3535408;Panorama;2030;15358;323;15681;97,94
3535507;Paraguaçu Paulista;2030;40899;4231;45130;90,62
3535606;Paraibuna;2030;5703;13213;18916;30,15
3535705;Paraíso;2030;5981;482;6463;92,54
3535804;Paranapanema;2030;19464;2231;21695;89,72
3535903;Paranapuã;2030;3621;276;3897;92,92
3536000;Parapuã;2030;9056;1106;10162;89,12
3536109;Pardinho;2030;6675;435;7110;93,88
3536208;Pariquera-Açu;2030;14382;5429;19811;72,6
3536257;Parisi;2030;1751;285;2036;86
3536307;Patrocínio Paulista;2030;13893;1808;15701;88,48
3536406;Paulicéia;2030;7195;556;7751;92,83
3536505;Paulínia;2030;120344;111;120455;99,91
3536570;Paulistânia;2030;1497;261;1758;85,15
3536604;Paulo de Faria;2030;7864;629;8493;92,59
3536703;Pederneiras;2030;44826;3374;48200;93
3536802;Pedra Bela;2030;1975;4050;6025;32,78
3536901;Pedranópolis;2030;1524;799;2323;65,6
3537008;Pedregulho;2030;12609;4039;16648;75,74
3537107;Pedreira;2030;49299;418;49717;99,16
3537156;Pedrinhas Paulista;2030;2713;328;3041;89,21
3537206;Pedro de Toledo;2030;8475;3242;11717;72,33
3537305;Penápolis;2030;60033;1526;61559;97,52
3537404;Pereira Barreto;2030;23949;1494;25443;94,13
3537503;Pereiras;2030;6071;3020;9091;66,78
3537602;Peruíbe;2030;71070;248;71318;99,65
3537701;Piacatu;2030;5936;348;6284;94,46
3537800;Piedade;2030;26561;27952;54513;48,72
3537909;Pilar do Sul;2030;25589;3824;29413;87
3538006;Pindamonhangaba;2030;169182;4056;173238;97,66
3538105;Pindorama;2030;15868;896;16764;94,66
3538204;Pinhalzinho;2030;8129;7673;15802;51,44
3538303;Piquerobi;2030;2911;583;3494;83,31
3538501;Piquete;2030;12579;805;13384;93,99
3538600;Piracaia;2030;27011;0;27011;100
3538709;Piracicaba;2030;395395;7008;402403;98,26
3538808;Piraju;2030;26524;1746;28270;93,82
3538907;Pirajuí;2030;19265;4080;23345;82,52
3539004;Pirangi;2030;10067;697;10764;93,52
3539103;Pirapora do Bom Jesus;2030;21686;0;21686;100
3539202;Pirapozinho;2030;28080;1003;29083;96,55
3539301;Pirassununga;2030;71568;3689;75257;95,1
3539400;Piratininga;2030;12472;1518;13990;89,15
3539509;Pitangueiras;2030;40353;686;41039;98,33
3539608;Planalto;2030;5161;500;5661;91,17
3539707;Platina;2030;3219;533;3752;85,79
3539806;Poá;2030;120328;1932;122260;98,42
3539905;Poloni;2030;5124;633;5757;89
3540002;Pompéia;2030;20875;1267;22142;94,28
3540101;Pongaí;2030;2944;290;3234;91,03
3540200;Pontal;2030;54497;339;54836;99,38
3540259;Pontalinda;2030;4270;458;4728;90,31
3540309;Pontes Gestal;2030;2312;217;2529;91,42
3540408;Populina;2030;3285;521;3806;86,31
3540507;Porangaba;2030;4780;5120;9900;48,28
3540606;Porto Feliz;2030;47840;5578;53418;89,56
3540705;Porto Ferreira;2030;54402;994;55396;98,21
3540754;Potim;2030;16470;5249;21719;75,83
3540804;Potirendaba;2030;15962;1195;17157;93,03
3540853;Pracinha;2030;1419;1544;2963;47,89
3540903;Pradópolis;2030;21803;1428;23231;93,85
3541000;Praia Grande;2030;354070;0;354070;100
3541059;Pratânia;2030;4883;790;5673;86,07
3541109;Presidente Alves;2030;3585;338;3923;91,38
3541208;Presidente Bernardes;2030;11954;1586;13540;88,29
3541307;Presidente Epitácio;2030;40679;2350;43029;94,54
3541406;Presidente Prudente;2030;223002;4644;227646;97,96
3541505;Presidente Venceslau;2030;36644;910;37554;97,58
3541604;Promissão;2030;37401;5347;42748;87,49
3541653;Quadra;2030;1060;2984;4044;26,21
3541703;Quatá;2030;14072;688;14760;95,34
3541802;Queiroz;2030;3391;269;3660;92,65
3541901;Queluz;2030;11033;2420;13453;82,01
3542008;Quitana;2030;6367;467;6834;93,17
3542107;Rafard;2030;8553;770;9323;91,74
3542206;Rancharia;2030;26992;1894;28886;93,44
3542305;Redenção da Serra;2030;3165;637;3802;83,25
3542404;Regente Feijó;2030;19020;975;19995;95,12
3542503;Reginópolis;2030;4221;2865;7086;59,57
3542602;Registro;2030;48631;6150;54781;88,77
3542701;Restinga;2030;7067;1188;8255;85,61
3542800;Ribeira;2030;1775;1458;3233;54,9
3542909;Ribeirão Bonito;2030;13063;569;13632;95,83
3543006;Ribeirão Branco;2030;11891;5794;17685;67,24
3543105;Ribeirão Corrente;2030;4267;720;4987;85,56
3543204;Ribeirão do Sul;2030;3708;545;4253;87,19
3543238;Ribeirão dos Índios;2030;1914;177;2091;91,54
3543253;Ribeirão Grande;2030;2416;5175;7591;31,83
3543303;Ribeirão Pires;2030;121747;0;121747;100
3543402;Ribeirão Preto;2030;724388;2062;726450;99,72
3543501;Riversul;2030;4328;1227;5555;77,91
3543600;Rifaina;2030;3118;352;3470;89,86
3543709;Rincão;2030;8840;1733;10573;83,61
3543808;Rinópolis;2030;8896;584;9480;93,84
3543907;Rio Claro;2030;205762;4242;210004;97,98
3544004;Rio das Pedras;2030;36980;696;37676;98,15
3544103;Rio Grande da Serra;2030;54393;0;54393;100
3544202;Riolândia;2030;9573;2528;12101;79,11
3544251;Rosana;2030;17444;386;17830;97,84
3544301;Roseira;2030;10982;377;11359;96,68
3544400;Rubiácea;2030;2148;1257;3405;63,08
3544509;Rubinéia;2030;2741;281;3022;90,7
3544608;Sabino;2030;5239;351;5590;93,72
3544707;Sagres;2030;2104;242;2346;89,68
3544806;Sales;2030;5905;394;6299;93,75
3544905;Sales Oliveira;2030;11573;462;12035;96,16
3545001;Salesópolis;2030;12292;5540;17832;68,93
3545100;Salmourão;2030;5104;199;5303;96,25
3545159;Saltinho;2030;6844;1271;8115;84,34
3545209;Salto;2030;120804;856;121660;99,3
3545308;Salto de Pirapora;2030;36995;9818;46813;79,03
3545407;Salto Grande;2030;8740;622;9362;93,36
3545506;Sandovalina;2030;4034;594;4628;87,17
3545605;Santa Adélia;2030;14343;818;15161;94,6
3545704;Santa Albertina;2030;5023;479;5502;91,29
3545803;Santa Bárbara d'Oeste;2030;191637;1516;193153;99,22
3546009;Santa Branca;2030;12735;1703;14438;88,2
3546108;Santa Clara d'Oeste;2030;1624;301;1925;84,36
3546207;Santa Cruz da Conceição;2030;3878;647;4525;85,7
3546256;Santa Cruz da Esperança;2030;1509;651;2160;69,86
3546306;Santa Cruz das Palmeiras;2030;35698;677;36375;98,14
3546405;Santa Cruz do Rio Pardo;2030;45126;2452;47578;94,85
3546504;Santa Ernestina;2030;5356;167;5523;96,98
3546603;Santa Fé do Sul;2030;30151;1236;31387;96,06
3546702;Santa Gertrudes;2030;29564;318;29882;98,94
3546801;Santa Isabel;2030;48645;9546;58191;83,6
3546900;Santa Lucia;2030;8531;297;8828;96,64
3547007;Santa Maria da Serra;2030;6312;478;6790;92,96
3547106;Santa Mercedes;2030;2669;163;2832;94,24
3547205;Santana da Ponte Pensa;2030;1111;284;1395;79,64
3547304;Santana de Parnaíba;2030;162322;0;162322;100
3547403;Santa Rita d'Oeste;2030;1905;338;2243;84,93
3547502;Santa Rita do Passa Quatro;2030;24382;1653;26035;93,65
3547601;Santa Rosa do Viterbo;2030;25833;816;26649;96,94
3547650;Santa Salete;2030;1147;254;1401;81,87
3547700;Santo Anastácio;2030;18921;967;19888;95,14
3547809;Santo André;2030;697124;0;697124;100
3547908;Santo Antonio da Alegria;2030;5206;1596;6802;76,54
3548005;Santo Antonio da Posse;2030;23790;663;24453;97,29
3548054;Santo Antonio do Aracanguá;2030;7926;680;8606;92,1
3548104;Santo Antonio do Jardim;2030;4095;1692;5787;70,76
3548203;Santo Antonio do Pinhal;2030;5308;1461;6769;78,42
3548302;Santo Expedito;2030;2962;130;3092;95,8
3548401;Santópolis do Aguapeí;2030;4827;104;4931;97,89
3548500;Santos;2030;435203;326;435529;99,93
3548609;São Bento do Sapucaí;2030;5823;4752;10575;55,06
3548708;São Bernardo do Campo;2030;823493;12953;836446;98,45
3548807;São Caetano do Sul;2030;148700;0;148700;100
3548906;São Carlos;2030;243767;10170;253937;96
3549003;São Francisco;2030;2201;372;2573;85,54
3549102;São João da Boa Vista;2030;86597;1839;88436;97,92
3549201;São João das Duas Pontes;2030;1838;527;2365;77,72
3549250;São João de Iracema;2030;1746;120;1866;93,57
3549300;São João do Pau d'Alho;2030;1684;182;1866;90,25
3549409;São Joaquim da Barra;2030;51675;925;52600;98,24
3549508;São José da Bela Vista;2030;8393;640;9033;92,91
3549607;São José do Barreiro;2030;3504;595;4099;85,48
3549706;São José do Rio Pardo;2030;50631;2946;53577;94,5
3549805;São José do Rio Preto;2030;437952;28286;466238;93,93
3549904;São José dos Campos;2030;748271;15539;763810;97,97
3549953;São Lourenço da Serra;2030;15978;909;16887;94,62
3550001;São Luís do Paraitinga;2030;6462;4225;10687;60,47
3550100;São Manuel;2030;40005;442;40447;98,91
3550209;São Miguel Arcanjo;2030;27618;5470;33088;83,47
3550308;São Paulo;2030;12132918;110053;12242971;99,1
3550407;São Pedro;2030;32111;3786;35897;89,45
3550506;São Pedro do Turvo;2030;6239;1293;7532;82,83
3550605;São Roque;2030;90836;1493;92329;98,38
3550704;São Sebastião;2030;95675;1090;96765;98,87
3550803;São Sebastião da Grama;2030;8965;2862;11827;75,8
3550902;São Simão;2030;14289;899;15188;94,08
3551009;São Vicente;2030;377516;714;378230;99,81
3551108;Sarapuí;2030;9428;1571;10999;85,72
3551207;Sarutaiá;2030;3319;370;3689;89,97
3551306;Sebastianópolis do Sul;2030;3020;348;3368;89,67
3551405;Serra Azul;2030;9394;3795;13189;71,23
3551504;Serrana;2030;48134;186;48320;99,62
3551603;Serra Negra;2030;24191;3484;27675;87,41
3551702;Sertãozinho;2030;128431;419;128850;99,67
3551801;Sete Barras;2030;10517;2330;12847;81,86
3551900;Severínia;2030;17789;572;18361;96,88
3552007;Silveiras;2030;3770;2744;6514;57,88
3552106;Socorro;2030;29611;9927;39538;74,89
3552205;Sorocaba;2030;694431;7140;701571;98,98
3552304;Sud Mennucci;2030;6757;1068;7825;86,35
3552403;Sumaré;2030;309692;3689;313381;98,82
3552502;Suzano;2030;302717;11045;313762;96,48
3552551;Suzanópolis;2030;2889;1440;4329;66,74
3552601;Tabapuã;2030;11304;734;12038;93,9
3552700;Tabatinga;2030;15636;1139;16775;93,21
3552809;Taboão da Serra;2030;314320;0;314320;100
3552908;Taciba;2030;5681;615;6296;90,23
3553005;Taguaí;2030;10736;4251;14987;71,64
3553104;Taiaçu;2030;5783;317;6100;94,8
3553203;Taiúva;2030;5826;285;6111;95,34
3553302;Tambaú;2030;21558;1562;23120;93,24
3553401;Tanabi;2030;23702;1580;25282;93,75
3553500;Tapiraí;2030;6112;1680;7792;78,44
3553609;Tapiratiba;2030;11730;790;12520;93,69
3553658;Taquaral;2030;2690;74;2764;97,32
3553708;Taquaritinga;2030;52709;1760;54469;96,77
3553807;Taquarituba;2030;22133;1533;23666;93,52
3553856;Taquarivaí;2030;3871;2425;6296;61,48
3553906;Tarabaí;2030;7417;378;7795;95,15
3553955;Tarumã;2030;15395;736;16131;95,44
3554003;Tatuí;2030;127519;2490;130009;98,08
3554102;Taubaté;2030;318147;6607;324754;97,97
3554201;Tejupá;2030;4074;719;4793;85
3554300;Teodoro Sampaio;2030;19417;3681;23098;84,06
3554409;Terra Roxa;2030;9240;320;9560;96,65
3554508;Tietê;2030;40456;3614;44070;91,8
3554607;Timburi;2030;2046;438;2484;82,37
3554656;Torre de Pedra;2030;1803;555;2358;76,46
3554706;Torrinha;2030;8797;1063;9860;89,22
3554755;Trabiju;2030;1728;93;1821;94,89
3554805;Tremembé;2030;46844;2530;49374;94,88
3554904;Três Fronteiras;2030;5024;512;5536;90,75
3554953;Tuiuti;2030;4024;2860;6884;58,45
3555000;Tupã;2030;58938;2463;61401;95,99
3555109;Tupi Paulista;2030;11598;3169;14767;78,54
3555208;Turiúba;2030;1599;240;1839;86,95
3555307;Turmalina;2030;1327;330;1657;80,08
3555356;Ubarana;2030;6149;464;6613;92,98
3555406;Ubatuba;2030;94320;2195;96515;97,73
3555505;Ubirajara;2030;3610;1233;4843;74,54
3555604;Uchôa;2030;9096;590;9686;93,91
3555703;União Paulista;2030;1548;305;1853;83,54
3555802;Urânia;2030;7411;891;8302;89,27
3555901;Uru;2030;1131;39;1170;96,67
3556008;Urupês;2030;12322;918;13240;93,07
3556107;Valentim Gentil;2030;12935;898;13833;93,51
3556206;Valinhos;2030;128328;5310;133638;96,03
3556305;Valparaíso;2030;24427;524;24951;97,9
3556354;Vargem;2030;8007;2835;10842;73,85
3556404;Vargem Grande do Sul;2030;41766;1282;43048;97,02
3556453;Vargem Grande Paulista;2030;61050;0;61050;100
3556503;Várzea Paulista;2030;128969;0;128969;100
3556602;Vera Cruz;2030;9493;840;10333;91,87
3556701;Vinhedo;2030;82959;2692;85651;96,86
3556800;Viradouro;2030;18473;557;19030;97,07
3556909;Vista Alegre do Alto;2030;8321;352;8673;95,94
3556958;Vitória Brasil;2030;1603;146;1749;91,65
3557006;Votorantim;2030;122417;4854;127271;96,19
3557105;Votuporanga;2030;91858;2648;94506;97,2
3557154;Zacarias;2030;2389;289;2678;89,21
3557204;Chavantes;2030;11649;600;12249;95,1
3557303;Estiva Gerbi;2030;9368;2378;11746;79,75
3500105;Adamantina;2035;32181;833;33014;97,48
3500204;Adolfo;2035;3033;206;3239;93,64
3500303;Aguaí;2035;36719;2197;38916;94,35
3500402;Águas da Prata;2035;7352;392;7744;94,94
3500501;Águas de Lindóia;2035;18758;170;18928;99,1
3500550;Águas de Santa Bárbara;2035;4962;1229;6191;80,15
3500600;Águas de São Pedro;2035;3315;0;3315;100
3500709;Agudos;2035;36149;1067;37216;97,13
3500758;Alambari;2035;5954;740;6694;88,95
3500808;Alfredo Marcondes;2035;3618;177;3795;95,34
3500907;Altair;2035;3768;420;4188;89,97
3501004;Altinópolis;2035;14607;652;15259;95,73
3501103;Alto Alegre;2035;3467;344;3811;90,97
3501152;Alumínio;2035;16092;3095;19187;83,87
3501202;Álvares Florence;2035;2571;634;3205;80,22
3501301;Álvares Machado;2035;22238;1726;23964;92,8
3501400;Álvaro de Carvalho;2035;3993;1498;5491;72,72
3501509;Alvinlândia;2035;3146;197;3343;94,11
3501608;Americana;2035;247550;1162;248712;99,53
3501707;Américo Brasiliense;2035;45016;343;45359;99,24
3501806;Américo de Campos;2035;5038;507;5545;90,86
3501905;Amparo;2035;63733;7122;70855;89,95
3502002;Analândia;2035;4789;602;5391;88,83
3502101;Andradina;2035;53184;2571;55755;95,39
3502200;Angatuba;2035;21120;5655;26775;78,88
3502309;Anhembi;2035;6397;1314;7711;82,96
3502408;Anhumas;2035;3872;291;4163;93,01
3502507;Aparecida;2035;35136;518;35654;98,55
3502606;Aparecida d'Oeste;2035;3364;337;3701;90,89
3502705;Apiaí;2035;22795;2597;25392;89,77
3502754;Araçariguama;2035;24863;0;24863;100
3502804;Araçatuba;2035;188414;3705;192119;98,07
3502903;Araçoiaba da Serra;2035;26031;11840;37871;68,74
3503000;Aramina;2035;5528;127;5655;97,75
3503109;Arandu;2035;5549;625;6174;89,88
3503158;Arapeí;2035;1961;460;2421;81
3503208;Araraquara;2035;230297;6739;237036;97,16
3503307;Araras;2035;133834;5693;139527;95,92
3503356;Arco-Íris;2035;1216;441;1657;73,39
3503406;Arealva;2035;7489;885;8374;89,43
3503505;Areias;2035;2743;1348;4091;67,05
3503604;Areiópolis;2035;10943;460;11403;95,97
3503703;Ariranha;2035;9368;524;9892;94,7
3503802;Artur Nogueira;2035;54227;5666;59893;90,54
3503901;Arujá;2035;101751;3473;105224;96,7
3503950;Aspásia;2035;1359;313;1672;81,28
3504008;Assis;2035;100900;4605;105505;95,64
3504107;Atibaia;2035;144414;6047;150461;95,98
3504206;Auriflama;2035;13624;639;14263;95,52
3504305;Avaí;2035;3724;1822;5546;67,15
3504404;Avanhandava;2035;11006;2010;13016;84,56
3504503;Avaré;2035;87993;2349;90342;97,4
3504602;Bady Bassitt;2035;16228;1048;17276;93,93
3504701;Balbinos;2035;1191;2514;3705;32,15
3504800;Bálsamo;2035;8034;529;8563;93,82
3504909;Bananal;2035;9955;1166;11121;89,52
3505005;Barão de Antonina;2035;2467;1208;3675;67,13
3505104;Barbosa;2035;6994;1055;8049;86,89
3505203;Bariri;2035;34868;891;35759;97,51
3505302;Barra Bonita;2035;33077;579;33656;98,28
3505351;Barra do Chapéu;2035;1751;4195;5946;29,45
3505401;Barra do Turvo;2035;4422;3618;8040;55
3505500;Barretos;2035;116809;3670;120479;96,95
3505609;Barrinha;2035;35895;403;36298;98,89
3505708;Barueri;2035;287512;0;287512;100
3505807;Bastos;2035;18310;1741;20051;91,32
3505906;Batatais;2035;55444;7250;62694;88,44
3506003;Bauru;2035;367898;6259;374157;98,33
3506102;Bebedouro;2035;68206;2333;70539;96,69
3506201;Bento de Abreu;2035;3112;79;3191;97,52
3506300;Bernardino de Campos;2035;9987;721;10708;93,27
3506359;Bertioga;2035;79614;344;79958;99,57
3506409;Bilac;2035;7813;300;8113;96,3
3506508;Birigui;2035;126520;3011;129531;97,68
3506607;Biritiba Mirim;2035;32748;4006;36754;89,1
3506706;Boa Esperança do Sul;2035;14605;874;15479;94,35
3506805;Bocaina;2035;12693;677;13370;94,94
3506904;Bofete;2035;7936;4512;12448;63,75
3507001;Boituva;2035;61703;3891;65594;94,07
3507100;Bom Jesus dos Perdões;2035;26568;1699;28267;93,99
3507159;Bom Sucesso de Itararé;2035;3580;745;4325;82,77
3507209;Borá;2035;615;175;790;77,85
3507308;Boracéia;2035;4834;359;5193;93,09
3507407;Borborema;2035;15018;585;15603;96,25
3507456;Borebi;2035;2762;94;2856;96,71
3507506;Botucatu;2035;146756;4500;151256;97,02
3507605;Bragança Paulista;2035;174262;3064;177326;98,27
3507704;Braúna;2035;5805;224;6029;96,28
3507753;Brejo Alegre;2035;2609;283;2892;90,21
3507803;Brodowski;2035;25912;147;26059;99,44
3507902;Brotas;2035;22902;3126;26028;87,99
3508009;Buri;2035;19012;2771;21783;87,28
3508108;Buritama;2035;16730;481;17211;97,21
3508207;Buritizal;2035;3859;588;4447;86,78
3508306;Cabrália Paulista;2035;3763;498;4261;88,31
3508405;Cabreúva;2035;54782;3514;58296;93,97
3508504;Caçapava;2035;81613;13770;95383;85,56
3508603;Cachoeira Paulista;2035;28915;4748;33663;85,9
3508702;Caconde;2035;14622;4446;19068;76,68
3508801;Cafelândia;2035;16472;1175;17647;93,34
3508900;Caiabu;2035;3685;414;4099;89,9
3509007;Caieiras;2035;112925;1397;114322;98,78
3509106;Caiuá;2035;2317;3732;6049;38,3
3509205;Cajamar;2035;92799;874;93673;99,07
3509254;Cajati;2035;23535;7546;31081;75,72
3509304;Cajobi;2035;9790;400;10190;96,07
3509403;Cajuru;2035;24976;2790;27766;89,95
3509452;Campina do Monte Alegre;2035;5506;484;5990;91,92
3509502;Campinas;2035;1210564;21180;1231744;98,28
3509601;Campo Limpo Paulista;2035;90323;0;90323;100
3509700;Campos do Jordão;2035;51678;324;52002;99,38
3509809;Campos Novos Paulista;2035;4493;622;5115;87,84
3509908;Cananéia;2035;11395;1568;12963;87,9
3509957;Canas;2035;5612;138;5750;97,6
3510005;Cândido Mota;2035;27882;1332;29214;95,44
3510104;Cândido Rodrigues;2035;2333;248;2581;90,39
3510153;Canitar;2035;5497;258;5755;95,52
3510203;Capão Bonito;2035;42035;5322;47357;88,76
3510302;Capela do Alto;2035;22114;2173;24287;91,05
3510401;Capivari;2035;58514;1058;59572;98,22
3510500;Caraguatatuba;2035;124202;4156;128358;96,76
3510609;Carapicuíba;2035;418301;0;418301;100
3510708;Cardoso;2035;10602;806;11408;92,93
3510807;Casa Branca;2035;25460;4746;30206;84,29
3510906;Cássia dos Coqueiros;2035;2045;322;2367;86,4
3511003;Castilho;2035;17518;5695;23213;75,47
3511102;Catanduva;2035;116238;941;117179;99,2
3511201;Catiguá;2035;7242;489;7731;93,67
3511300;Cedral;2035;8169;1220;9389;87,01
3511409;Cerqueira César;2035;19784;1069;20853;94,87
3511508;Cerquilho;2035;49976;2727;52703;94,83
3511607;Cesário Lange;2035;12465;5998;18463;67,51
3511706;Charqueada;2035;17218;1398;18616;92,49
3511904;Clementina;2035;9241;213;9454;97,75
3512001;Colina;2035;16716;613;17329;96,46
3512100;Colômbia;2035;4738;1265;6003;78,93
3512209;Conchal;2035;28604;626;29230;97,86
3512308;Conchas;2035;16144;1752;17896;90,21
3512407;Cordeirópolis;2035;24739;2804;27543;89,82
3512506;Coroados;2035;5767;589;6356;90,73
3512605;Coronel Macedo;2035;4151;598;4749;87,41
3512704;Corumbataí;2035;2968;1065;4033;73,59
3512803;Cosmópolis;2035;76944;5905;82849;92,87
3512902;Cosmorama;2035;5597;998;6595;84,87
3513009;Cotia;2035;300039;0;300039;100
3513108;Cravinhos;2035;36265;276;36541;99,24
3513207;Cristais Paulista;2035;8390;757;9147;91,72
3513306;Cruzália;2035;1507;439;1946;77,44
3513405;Cruzeiro;2035;79945;1721;81666;97,89
3513504;Cubatão;2035;139638;0;139638;100
3513603;Cunha;2035;15412;5905;21317;72,3
3513702;Descalvado;2035;31390;1536;32926;95,33
3513801;Diadema;2035;417321;0;417321;100
3513850;Dirce Reis;2035;1474;190;1664;88,58
3513900;Divinolândia;2035;8881;1615;10496;84,61
3514007;Dobrada;2035;9655;220;9875;97,77
3514106;Dois Córregos;2035;28556;603;29159;97,93
3514205;Dolcinópolis;2035;1798;116;1914;93,94
3514304;Dourado;2035;7467;638;8105;92,13
3514403;Dracena;2035;42394;2885;45279;93,63
3514502;Duartina;2035;10806;604;11410;94,71
3514601;Dumont;2035;10450;85;10535;99,19
3514700;Echaporã;2035;5215;818;6033;86,44
3514809;Eldorado;2035;8128;8388;16516;49,21
3514908;Elias Fausto;2035;16638;1994;18632;89,3
3514924;Elisiário;2035;3423;224;3647;93,86
3514957;Embaúba;2035;2159;177;2336;92,42
3515004;Embu;2035;302057;0;302057;100
3515103;Embu-Guaçu;2035;72555;1988;74543;97,33
3515129;Emilianópolis;2035;2789;224;3013;92,57
3515152;Engenheiro Coelho;2035;19911;4920;24831;80,19
3515186;Espírito Santo do Pinhal;2035;39837;2657;42494;93,75
3515194;Espírito Santo do Turvo;2035;4656;787;5443;85,54
3515202;Estrela d'Oeste;2035;7084;727;7811;90,69
3515301;Estrela do Norte;2035;2512;189;2701;93
3515350;Euclides da Cunha Paulista;2035;6405;3343;9748;65,71
3515400;Fartura;2035;14004;1975;15979;87,64
3515509;Fernandópolis;2035;63006;1991;64997;96,94
3515608;Fernando Prestes;2035;5108;290;5398;94,63
3515657;Fernão;2035;1220;514;1734;70,36
3515707;Ferraz de Vasconcelos;2035;209569;9845;219414;95,51
3515806;Flora Rica;2035;1315;101;1416;92,87
3515905;Floreal;2035;2302;301;2603;88,44
3516002;Flórida Paulista;2035;8854;2368;11222;78,9
3516101;Florínia;2035;2419;161;2580;93,76
3516200;Franca;2035;352455;6298;358753;98,24
3516309;Francisco Morato;2035;200820;409;201229;99,8
3516408;Franco da Rocha;2035;160587;13722;174309;92,13
3516507;Gabriel Monteiro;2035;2380;159;2539;93,74
3516606;Gália;2035;5013;1145;6158;81,41
3516705;Garça;2035;38620;1998;40618;95,08
3516804;Gastão Vidigal;2035;5124;180;5304;96,61
3516853;Gavião Peixoto;2035;4514;251;4765;94,73
3516903;General Salgado;2035;9414;808;10222;92,1
3517000;Getulina;2035;9392;1477;10869;86,41
3517109;Glicério;2035;3961;900;4861;81,49
3517208;Guaiçara;2035;12470;599;13069;95,42
3517307;Guaimbê;2035;5402;306;5708;94,64
3517406;Guaíra;2035;38328;1206;39534;96,95
3517505;Guapiaçu;2035;21397;1693;23090;92,67
3517604;Guapiara;2035;8393;10162;18555;45,23
3517703;Guará;2035;21483;423;21906;98,07
3517802;Guaraçai;2035;7003;1122;8125;86,19
3517901;Guaraci;2035;11223;541;11764;95,4
3518008;Guarani d'Oeste;2035;1679;170;1849;90,81
3518107;Guarantã;2035;6247;315;6562;95,2
3518206;Guararapes;2035;31195;1455;32650;95,54
3518305;Guararema;2035;28653;4643;33296;86,06
3518404;Guaratinguetá;2035;115919;5426;121345;95,53
3518503;Guareí;2035;9672;7073;16745;57,76
3518602;Guariba;2035;41525;450;41975;98,93
3518701;Guarujá;2035;344383;66;344449;99,98
3518800;Guarulhos;2035;1481593;0;1481593;100
3518859;Guatapará;2035;6952;940;7892;88,09
3518909;Guzolândia;2035;5043;360;5403;93,34
3519006;Herculândia;2035;9402;494;9896;95,01
3519055;Holambra;2035;16204;1066;17270;93,83
3519071;Hortolândia;2035;269789;0;269789;100
3519105;Iacanga;2035;11246;1165;12411;90,61
3519204;Iacri;2035;5368;601;5969;89,93
3519253;Iaras;2035;3354;4183;7537;44,5
3519303;Ibaté;2035;37183;1169;38352;96,95
3519402;Ibirá;2035;11958;782;12740;93,86
3519501;Ibirarema;2035;7828;415;8243;94,97
3519600;Ibitinga;2035;60095;1811;61906;97,07
3519709;Ibiúna;2035;32377;48980;81357;39,8
3519808;Icém;2035;7506;1041;8547;87,82
3519907;Iepê;2035;7821;335;8156;95,89
3520004;Igaraçu do Tietê;2035;24696;142;24838;99,43
3520103;Igarapava;2035;29399;1036;30435;96,6
3520202;Igaratá;2035;8972;825;9797;91,58
3520301;Iguape;2035;27036;3494;30530;88,56
3520400;Ilhabela;2035;37534;260;37794;99,31
3520426;Ilha Comprida;2035;11718;0;11718;100
3520442;Ilha Solteira;2035;23646;1552;25198;93,84
3520509;Indaiatuba;2035;268174;2723;270897;98,99
3520608;Indiana;2035;4249;412;4661;91,16
3520707;Indiaporã;2035;3423;260;3683;92,94
3520806;Inúbia Paulista;2035;3845;257;4102;93,73
3520905;Ipaussu;2035;14617;752;15369;95,11
3521002;Iperó;2035;24411;15149;39560;61,71
3521101;Ipeúna;2035;8839;505;9344;94,6
3521150;Ipiguá;2035;4070;1707;5777;70,45
3521200;Iporanga;2035;3638;1031;4669;77,92
3521309;Ipuã;2035;17060;423;17483;97,58
3521408;Iracemápolis;2035;26197;459;26656;98,28
3521507;Irapuã;2035;7516;516;8032;93,58
3521606;Irapuru;2035;4770;1977;6747;70,7
3521705;Itaberá;2035;15053;2653;17706;85,02
3521804;Itaí;2035;22789;6233;29022;78,52
3521903;Itajobi;2035;12884;1217;14101;91,37
3522000;Itaju;2035;3586;432;4018;89,25
3522109;Itanhaém;2035;109932;596;110528;99,46
3522158;Itaóca;2035;1740;1451;3191;54,53
3522208;Itapecerica da Serra;2035;187355;1566;188921;99,17
3522307;Itapetininga;2035;164908;11314;176222;93,58
3522406;Itapeva;2035;93214;3933;97147;95,95
3522505;Itapevi;2035;283494;0;283494;100
3522604;Itapira;2035;67515;3620;71135;94,91
3522653;Itapirapuã Paulista;2035;2549;2069;4618;55,2
3522703;Itápolis;2035;40425;1719;42144;95,92
3522802;Itaporanga;2035;13014;1832;14846;87,66
3522901;Itapuí;2035;15055;320;15375;97,92
3523008;Itapura;2035;4415;1109;5524;79,92
3523107;Itaquaquecetuba;2035;428076;0;428076;100
3523206;Itararé;2035;47227;3402;50629;93,28
3523305;Itariri;2035;15404;4049;19453;79,19
3523404;Itatiba;2035;117492;12591;130083;90,32
3523503;Itatinga;2035;22270;985;23255;95,76
3523602;Itirapina;2035;17587;960;18547;94,82
3523701;Itirapuã;2035;5987;668;6655;89,96
3523800;Itobi;2035;7240;242;7482;96,77
3523909;Itu;2035;176259;6177;182436;96,61
3524006;Itupeva;2035;71232;2171;73403;97,04
3524105;Ituverava;2035;38331;2383;40714;94,15
3524204;Jaborandi;2035;6366;260;6626;96,08
3524303;Jaboticabal;2035;73770;621;74391;99,17
3524402;Jacareí;2035;237324;3323;240647;98,62
3524501;Jaci;2035;7361;511;7872;93,51
3524600;Jacupiranga;2035;9543;7985;17528;54,44
3524709;Jaguariúna;2035;61216;1073;62289;98,28
3524808;Jales;2035;43258;2712;45970;94,1
3524907;Jambeiro;2035;3304;3596;6900;47,88
3525003;Jandira;2035;140674;0;140674;100
3525102;Jardinópolis;2035;46795;351;47146;99,26
3525201;Jarinu;2035;34032;2411;36443;93,38
3525300;Jaú;2035;155506;3133;158639;98,03
3525409;Jeriquara;2035;2856;258;3114;91,71
3525508;Joanópolis;2035;13198;0;13198;100
3525607;João Ramalho;2035;4233;355;4588;92,26
3525706;José Bonifácio;2035;36030;2542;38572;93,41
3525805;Júlio Mesquita;2035;4615;217;4832;95,51
3525854;Jumirim;2035;2842;905;3747;75,85
3525904;Jundiaí;2035;422770;9058;431828;97,9
3526001;Junqueirópolis;2035;18787;2443;21230;88,49
3526100;Juquiá;2035;13115;6008;19123;68,58
3526209;Juquitiba;2035;30628;2241;32869;93,18
3526308;Lagoinha;2035;3787;1020;4807;78,78
3526407;Laranjal Paulista;2035;27704;2442;30146;91,9
3526506;Lavínia;2035;3958;4152;8110;48,8
3526605;Lavrinhas;2035;7468;308;7776;96,04
3526704;Leme;2035;107362;1884;109246;98,28
3526803;Lençóis Paulista;2035;68652;1173;69825;98,32
3526902;Limeira;2035;302587;5949;308536;98,07
3527009;Lindóia;2035;8492;0;8492;100
3527108;Lins;2035;75512;893;76405;98,83
3527207;Lorena;2035;88144;1960;90104;97,82
3527256;Lourdes;2035;1924;215;2139;89,95
3527306;Louveira;2035;55846;1041;56887;98,17
3527405;Lucélia;2035;19097;2455;21552;88,61
3527504;Lucianópolis;2035;1908;348;2256;84,57
3527603;Luís Antônio;2035;16455;90;16545;99,46
3527702;Luiziânia;2035;6227;214;6441;96,68
3527801;Lupércio;2035;4270;201;4471;95,5
3527900;Lutécia;2035;2240;294;2534;88,4
3528007;Macatuba;2035;17115;315;17430;98,19
3528106;Macaubal;2035;6879;557;7436;92,51
3528205;Macedônia;2035;2812;536;3348;83,99
3528304;Magda;2035;2558;336;2894;88,39
3528403;Mairinque;2035;39376;9686;49062;80,26
3528502;Mairiporã;2035;111109;4539;115648;96,08
3528601;Manduri;2035;9502;350;9852;96,45
3528700;Marabá Paulista;2035;2246;2800;5046;44,51
3528809;Maracaí;2035;12580;799;13379;94,03
3528858;Marapoama;2035;2855;211;3066;93,12
3528908;Mariápolis;2035;3622;348;3970;91,23
3529005;Marília;2035;229878;10798;240676;95,51
3529104;Marinópolis;2035;1755;282;2037;86,16
3529203;Martinópolis;2035;24076;2586;26662;90,3
3529302;Matão;2035;79208;1481;80689;98,16
3529401;Mauá;2035;496634;0;496634;100
3529500;Mendonça;2035;4687;460;5147;91,06
3529609;Meridiano;2035;2683;823;3506;76,53
3529658;Mesópolis;2035;1722;155;1877;91,74
3529708;Miguelópolis;2035;21534;731;22265;96,72
3529807;Mineiros do Tietê;2035;12493;584;13077;95,53
3529906;Miracatu;2035;11853;8657;20510;57,79
3530003;Mira Estrela;2035;1984;991;2975;66,69
3530102;Mirandópolis;2035;27302;1801;29103;93,81
3530201;Mirante do Paranapanema;2035;10800;7541;18341;58,88
3530300;Mirassol;2035;58690;1521;60211;97,47
3530409;Mirassolândia;2035;4129;950;5079;81,3
3530508;Mococa;2035;63354;1944;65298;97,02
3530607;Mogi das Cruzes;2035;452548;31106;483654;93,57
3530706;Mogi-Guaçu;2035;150773;4797;155570;96,92
3530805;Moji Mirim;2035;89218;2486;91704;97,29
3530904;Mombuca;2035;3189;210;3399;93,82
3531001;Monções;2035;1880;241;2121;88,64
3531100;Mongaguá;2035;62058;272;62330;99,56
3531209;Monte Alegre do Sul;2035;5653;2496;8149;69,37
3531308;Monte Alto;2035;47276;877;48153;98,18
3531407;Monte Aprazível;2035;22533;1518;24051;93,69
3531506;Monte Azul Paulista;2035;16544;607;17151;96,46
3531605;Monte Castelo;2035;3387;433;3820;88,66
3531704;Monteiro Lobato;2035;2193;2544;4737;46,3
3531803;Monte Mor;2035;69533;2236;71769;96,88
3531902;Morro Agudo;2035;35142;659;35801;98,16
3532009;Morungaba;2035;13682;826;14508;94,31
3532058;Motuca;2035;4302;610;4912;87,58
3532108;Murutinga do Sul;2035;2573;1613;4186;61,47
3532157;Nantes;2035;3390;82;3472;97,64
3532207;Narandiba;2035;4872;554;5426;89,79
3532306;Natividade da Serra;2035;2931;3800;6731;43,54
3532405;Nazaré Paulista;2035;20075;365;20440;98,21
3532504;Neves Paulista;2035;7523;546;8069;93,23
3532603;Nhandeara;2035;8886;1287;10173;87,35
3532702;Nipoã;2035;5075;418;5493;92,39
3532801;Nova Aliança;2035;6149;605;6754;91,04
3532827;Nova Campina;2035;10063;1097;11160;90,17
3532843;Nova Canaã Paulista;2035;1066;620;1686;63,23
3532868;Nova Castilho;2035;1097;107;1204;91,11
3532900;Nova Europa;2035;11583;436;12019;96,37
3533007;Nova Granada;2035;21006;1363;22369;93,91
3533106;Nova Guataporanga;2035;1994;149;2143;93,05
3533205;Nova Independência;2035;3843;403;4246;90,51
3533254;Novais;2035;5909;387;6296;93,85
3533304;Nova Lusitânia;2035;4358;167;4525;96,31
3533403;Nova Odessa;2035;61861;1025;62886;98,37
3533502;Novo Horizonte;2035;37810;2447;40257;93,92
3533601;Nuporanga;2035;7313;183;7496;97,56
3533700;Ocauçu;2035;3728;338;4066;91,69
3533809;Óleo;2035;1873;490;2363;79,26
3533908;Olímpia;2035;51726;1982;53708;96,31
3534005;Onda Verde;2035;4071;431;4502;90,43
3534104;Oriente;2035;6021;286;6307;95,47
3534203;Orindiúva;2035;7382;487;7869;93,81
3534302;Orlândia;2035;42603;1127;43730;97,42
3534401;Osasco;2035;703823;0;703823;100
3534500;Oscar Bressane;2035;2173;193;2366;91,84
3534609;Osvaldo Cruz;2035;28270;2134;30404;92,98
3534708;Ourinhos;2035;113280;3003;116283;97,42
3534757;Ouroeste;2035;10212;666;10878;93,88
3534807;Ouro Verde;2035;8361;345;8706;96,04
3534906;Pacaembu;2035;9376;3349;12725;73,68
3535002;Palestina;2035;11223;1385;12608;89,01
3535101;Palmares Paulista;2035;14519;431;14950;97,12
3535200;Palmeira d'Oeste;2035;7400;1113;8513;86,93
3535309;Palmital;2035;20349;979;21328;95,41
3535408;Panorama;2035;15495;324;15819;97,95
3535507;Paraguaçu Paulista;2035;40977;4240;45217;90,62
3535606;Paraibuna;2035;5778;13387;19165;30,15
3535705;Paraíso;2035;6040;456;6496;92,98
3535804;Paranapanema;2035;20326;1970;22296;91,16
3535903;Paranapuã;2035;3597;260;3857;93,26
3536000;Parapuã;2035;8961;968;9929;90,25
3536109;Pardinho;2035;7057;334;7391;95,48
3536208;Pariquera-Açu;2035;14697;5303;20000;73,49
3536257;Parisi;2035;1746;262;2008;86,95
3536307;Patrocínio Paulista;2035;14492;1634;16126;89,87
3536406;Paulicéia;2035;7462;470;7932;94,07
3536505;Paulínia;2035;124572;115;124687;99,91
3536570;Paulistânia;2035;1525;210;1735;87,9
3536604;Paulo de Faria;2035;7861;601;8462;92,9
3536703;Pederneiras;2035;45358;3414;48772;93
3536802;Pedra Bela;2035;2096;3904;6000;34,93
3536901;Pedranópolis;2035;1501;759;2260;66,42
3537008;Pedregulho;2035;12772;3987;16759;76,21
3537107;Pedreira;2035;50151;425;50576;99,16
3537156;Pedrinhas Paulista;2035;2715;299;3014;90,08
3537206;Pedro de Toledo;2035;8744;3216;11960;73,11
3537305;Penápolis;2035;59815;1410;61225;97,7
3537404;Pereira Barreto;2035;23877;1429;25306;94,35
3537503;Pereiras;2035;6177;3072;9249;66,79
3537602;Peruíbe;2035;73085;198;73283;99,73
3537701;Piacatu;2035;6082;301;6383;95,28
3537800;Piedade;2035;27042;27571;54613;49,52
3537909;Pilar do Sul;2035;26365;3402;29767;88,57
3538006;Pindamonhangaba;2035;171588;3928;175516;97,76
3538105;Pindorama;2035;15844;895;16739;94,65
3538204;Pinhalzinho;2035;8315;7678;15993;51,99
3538303;Piquerobi;2035;2935;523;3458;84,88
3538501;Piquete;2035;12444;785;13229;94,07
3538600;Piracaia;2035;27072;0;27072;100
3538709;Piracicaba;2035;395992;6971;402963;98,27
3538808;Piraju;2035;26470;1535;28005;94,52
3538907;Pirajuí;2035;19211;3998;23209;82,77
3539004;Pirangi;2035;9994;624;10618;94,12
3539103;Pirapora do Bom Jesus;2035;22785;0;22785;100
3539202;Pirapozinho;2035;28647;950;29597;96,79
3539301;Pirassununga;2035;71771;3269;75040;95,64
3539400;Piratininga;2035;12708;1434;14142;89,86
3539509;Pitangueiras;2035;41287;576;41863;98,62
3539608;Planalto;2035;5353;470;5823;91,93
3539707;Platina;2035;3359;499;3858;87,07
3539806;Poá;2035;122466;1966;124432;98,42
3539905;Poloni;2035;5122;632;5754;89,02
3540002;Pompéia;2035;21041;1231;22272;94,47
3540101;Pongaí;2035;2904;245;3149;92,22
3540200;Pontal;2035;56484;289;56773;99,49
3540259;Pontalinda;2035;4380;421;4801;91,23
3540309;Pontes Gestal;2035;2324;198;2522;92,15
3540408;Populina;2035;3233;470;3703;87,31
3540507;Porangaba;2035;4832;5175;10007;48,29
3540606;Porto Feliz;2035;48639;5037;53676;90,62
3540705;Porto Ferreira;2035;54667;999;55666;98,21
3540754;Potim;2035;16693;5320;22013;75,83
3540804;Potirendaba;2035;16047;1148;17195;93,32
3540853;Pracinha;2035;1425;1552;2977;47,87
3540903;Pradópolis;2035;22560;1409;23969;94,12
3541000;Praia Grande;2035;365339;0;365339;100
3541059;Pratânia;2035;5141;705;5846;87,94
3541109;Presidente Alves;2035;3572;283;3855;92,66
3541208;Presidente Bernardes;2035;11982;1323;13305;90,06
3541307;Presidente Epitácio;2035;40758;2237;42995;94,8
3541406;Presidente Prudente;2035;223132;4646;227778;97,96
3541505;Presidente Venceslau;2035;36368;850;37218;97,72
3541604;Promissão;2035;38623;5175;43798;88,18
3541653;Quadra;2035;1095;3054;4149;26,39
3541703;Quatá;2035;14299;687;14986;95,42
3541802;Queiroz;2035;3535;247;3782;93,47
3541901;Queluz;2035;11208;2458;13666;82,01
3542008;Quitana;2035;6468;452;6920;93,47
3542107;Rafard;2035;8725;714;9439;92,44
3542206;Rancharia;2035;26994;1695;28689;94,09
3542305;Redenção da Serra;2035;3288;486;3774;87,12
3542404;Regente Feijó;2035;19133;883;20016;95,59
3542503;Reginópolis;2035;4174;2833;7007;59,57
3542602;Registro;2035;48898;6184;55082;88,77
3542701;Restinga;2035;7416;1110;8526;86,98
3542800;Ribeira;2035;1920;1313;3233;59,39
3542909;Ribeirão Bonito;2035;13343;529;13872;96,19
3543006;Ribeirão Branco;2035;12499;5139;17638;70,86
3543105;Ribeirão Corrente;2035;4431;675;5106;86,78
3543204;Ribeirão do Sul;2035;3716;456;4172;89,07
3543238;Ribeirão dos Índios;2035;1900;151;2051;92,64
3543253;Ribeirão Grande;2035;2446;5225;7671;31,89
3543303;Ribeirão Pires;2035;121724;0;121724;100
3543402;Ribeirão Preto;2035;734039;2089;736128;99,72
3543501;Riversul;2035;4361;1156;5517;79,05
3543600;Rifaina;2035;3106;332;3438;90,34
3543709;Rincão;2035;8902;1677;10579;84,15
3543808;Rinópolis;2035;8809;521;9330;94,42
3543907;Rio Claro;2035;207192;4146;211338;98,04
3544004;Rio das Pedras;2035;37938;691;38629;98,21
3544103;Rio Grande da Serra;2035;55867;0;55867;100
3544202;Riolândia;2035;9761;2577;12338;79,11
3544251;Rosana;2035;17247;365;17612;97,93
3544301;Roseira;2035;11230;356;11586;96,93
3544400;Rubiácea;2035;2260;1244;3504;64,5
3544509;Rubinéia;2035;2738;250;2988;91,63
3544608;Sabino;2035;5297;302;5599;94,61
3544707;Sagres;2035;2128;195;2323;91,61
3544806;Sales;2035;5933;389;6322;93,85
3544905;Sales Oliveira;2035;11708;393;12101;96,75
3545001;Salesópolis;2035;12764;5423;18187;70,18
3545100;Salmourão;2035;5146;169;5315;96,82
3545159;Saltinho;2035;6840;1250;8090;84,55
3545209;Salto;2035;122208;865;123073;99,3
3545308;Salto de Pirapora;2035;37591;9884;47475;79,18
3545407;Salto Grande;2035;8875;587;9462;93,8
3545506;Sandovalina;2035;4273;492;4765;89,67
3545605;Santa Adélia;2035;14320;816;15136;94,61
3545704;Santa Albertina;2035;4933;430;5363;91,98
3545803;Santa Bárbara d'Oeste;2035;191328;1514;192842;99,21
3546009;Santa Branca;2035;12751;1705;14456;88,21
3546108;Santa Clara d'Oeste;2035;1615;265;1880;85,9
3546207;Santa Cruz da Conceição;2035;4012;522;4534;88,49
3546256;Santa Cruz da Esperança;2035;1536;646;2182;70,39
3546306;Santa Cruz das Palmeiras;2035;36486;669;37155;98,2
3546405;Santa Cruz do Rio Pardo;2035;45558;2351;47909;95,09
3546504;Santa Ernestina;2035;5343;161;5504;97,07
3546603;Santa Fé do Sul;2035;29980;1229;31209;96,06
3546702;Santa Gertrudes;2035;30909;332;31241;98,94
3546801;Santa Isabel;2035;50090;9047;59137;84,7
3546900;Santa Lucia;2035;8639;284;8923;96,82
3547007;Santa Maria da Serra;2035;6615;439;7054;93,78
3547106;Santa Mercedes;2035;2699;138;2837;95,14
3547205;Santana da Ponte Pensa;2035;1091;241;1332;81,91
3547304;Santana de Parnaíba;2035;171317;0;171317;100
3547403;Santa Rita d'Oeste;2035;1867;277;2144;87,08
3547502;Santa Rita do Passa Quatro;2035;24211;1467;25678;94,29
3547601;Santa Rosa do Viterbo;2035;26010;739;26749;97,24
3547650;Santa Salete;2035;1161;200;1361;85,3
3547700;Santo Anastácio;2035;18828;890;19718;95,49
3547809;Santo André;2035;692476;0;692476;100
3547908;Santo Antonio da Alegria;2035;5231;1550;6781;77,14
3548005;Santo Antonio da Posse;2035;24328;578;24906;97,68
3548054;Santo Antonio do Aracanguá;2035;8115;542;8657;93,74
3548104;Santo Antonio do Jardim;2035;4206;1536;5742;73,25
3548203;Santo Antonio do Pinhal;2035;5589;1236;6825;81,89
3548302;Santo Expedito;2035;3014;110;3124;96,48
3548401;Santópolis do Aguapeí;2035;4902;102;5004;97,96
3548500;Santos;2035;436321;327;436648;99,93
3548609;São Bento do Sapucaí;2035;5964;4542;10506;56,77
3548708;São Bernardo do Campo;2035;827274;12776;840050;98,48
3548807;São Caetano do Sul;2035;145866;0;145866;100
3548906;São Carlos;2035;245370;10237;255607;96
3549003;São Francisco;2035;2183;329;2512;86,9
3549102;São João da Boa Vista;2035;85949;1705;87654;98,05
3549201;São João das Duas Pontes;2035;1805;509;2314;78
3549250;São João de Iracema;2035;1754;94;1848;94,91
3549300;São João do Pau d'Alho;2035;1653;149;1802;91,73
3549409;São Joaquim da Barra;2035;52099;932;53031;98,24
3549508;São José da Bela Vista;2035;8562;584;9146;93,61
3549607;São José do Barreiro;2035;3612;496;4108;87,93
3549706;São José do Rio Pardo;2035;50780;2494;53274;95,32
3549805;São José do Rio Preto;2035;439065;28357;467422;93,93
3549904;São José dos Campos;2035;762881;15842;778723;97,97
3549953;São Lourenço da Serra;2035;16491;824;17315;95,24
3550001;São Luís do Paraitinga;2035;6491;4199;10690;60,72
3550100;São Manuel;2035;40155;428;40583;98,95
3550209;São Miguel Arcanjo;2035;28885;4650;33535;86,13
3550308;São Paulo;2035;12219483;110839;12330322;99,1
3550407;São Pedro;2035;32807;3452;36259;90,48
3550506;São Pedro do Turvo;2035;6399;1143;7542;84,84
3550605;São Roque;2035;92217;1237;93454;98,68
3550704;São Sebastião;2035;99076;1129;100205;98,87
3550803;São Sebastião da Grama;2035;9130;2587;11717;77,92
3550902;São Simão;2035;14403;790;15193;94,8
3551009;São Vicente;2035;383100;725;383825;99,81
3551108;Sarapuí;2035;9942;1374;11316;87,86
3551207;Sarutaiá;2035;3379;319;3698;91,37
3551306;Sebastianópolis do Sul;2035;3041;303;3344;90,94
3551405;Serra Azul;2035;9605;3880;13485;71,23
3551504;Serrana;2035;49346;171;49517;99,65
3551603;Serra Negra;2035;24033;3412;27445;87,57
3551702;Sertãozinho;2035;129830;394;130224;99,7
3551801;Sete Barras;2035;10957;2023;12980;84,41
3551900;Severínia;2035;18144;576;18720;96,92
3552007;Silveiras;2035;3960;2654;6614;59,87
3552106;Socorro;2035;30087;9274;39361;76,44
3552205;Sorocaba;2035;704419;7242;711661;98,98
3552304;Sud Mennucci;2035;6772;1061;7833;86,45
3552403;Sumaré;2035;320148;3814;323962;98,82
3552502;Suzano;2035;310397;11326;321723;96,48
3552551;Suzanópolis;2035;2970;1480;4450;66,74
3552601;Tabapuã;2035;11247;728;11975;93,92
3552700;Tabatinga;2035;16002;991;16993;94,17
3552809;Taboão da Serra;2035;326192;0;326192;100
3552908;Taciba;2035;5794;559;6353;91,2
3553005;Taguaí;2035;11139;4410;15549;71,64
3553104;Taiaçu;2035;5804;284;6088;95,34
3553203;Taiúva;2035;5729;252;5981;95,79
3553302;Tambaú;2035;21727;1388;23115;94
3553401;Tanabi;2035;23484;1539;25023;93,85
3553500;Tapiraí;2035;6268;1572;7840;79,95
3553609;Tapiratiba;2035;11764;623;12387;94,97
3553658;Taquaral;2035;2688;66;2754;97,6
3553708;Taquaritinga;2035;52369;1669;54038;96,91
3553807;Taquarituba;2035;22376;1317;23693;94,44
3553856;Taquarivaí;2035;4103;2393;6496;63,16
3553906;Tarabaí;2035;7606;351;7957;95,59
3553955;Tarumã;2035;15789;748;16537;95,48
3554003;Tatuí;2035;131157;2193;133350;98,36
3554102;Taubaté;2035;321506;6677;328183;97,97
3554201;Tejupá;2035;4262;574;4836;88,13
3554300;Teodoro Sampaio;2035;19745;3563;23308;84,71
3554409;Terra Roxa;2035;9356;314;9670;96,75
3554508;Tietê;2035;41448;3601;45049;92,01
3554607;Timburi;2035;2048;385;2433;84,18
3554656;Torre de Pedra;2035;1851;498;2349;78,8
3554706;Torrinha;2035;8826;975;9801;90,05
3554755;Trabiju;2035;1760;86;1846;95,34
3554805;Tremembé;2035;48041;2247;50288;95,53
3554904;Três Fronteiras;2035;5012;464;5476;91,53
3554953;Tuiuti;2035;4197;2742;6939;60,48
3555000;Tupã;2035;57932;2421;60353;95,99
3555109;Tupi Paulista;2035;11393;3113;14506;78,54
3555208;Turiúba;2035;1576;215;1791;88
3555307;Turmalina;2035;1290;287;1577;81,8
3555356;Ubarana;2035;6325;463;6788;93,18
3555406;Ubatuba;2035;96652;2225;98877;97,75
3555505;Ubirajara;2035;3660;1224;4884;74,94
3555604;Uchôa;2035;8987;581;9568;93,93
3555703;União Paulista;2035;1610;287;1897;84,87
3555802;Urânia;2035;7288;802;8090;90,09
3555901;Uru;2035;1122;30;1152;97,4
3556008;Urupês;2035;12242;868;13110;93,38
3556107;Valentim Gentil;2035;13198;892;14090;93,67
3556206;Valinhos;2035;130590;5154;135744;96,2
3556305;Valparaíso;2035;24721;508;25229;97,99
3556354;Vargem;2035;8608;2373;10981;78,39
3556404;Vargem Grande do Sul;2035;42202;1172;43374;97,3
3556453;Vargem Grande Paulista;2035;64455;0;64455;100
3556503;Várzea Paulista;2035;131484;0;131484;100
3556602;Vera Cruz;2035;9468;758;10226;92,59
3556701;Vinhedo;2035;84857;2753;87610;96,86
3556800;Viradouro;2035;18656;562;19218;97,08
3556909;Vista Alegre do Alto;2035;8525;330;8855;96,27
3556958;Vitória Brasil;2035;1594;130;1724;92,46
3557006;Votorantim;2035;124282;4928;129210;96,19
3557105;Votuporanga;2035;91489;2637;94126;97,2
3557154;Zacarias;2035;2442;257;2699;90,48
3557204;Chavantes;2035;11668;579;12247;95,27
3557303;Estiva Gerbi;2035;9455;2400;11855;79,76
3500105;Adamantina;2040;31654;766;32420;97,64
3500204;Adolfo;2040;2943;196;3139;93,76
3500303;Aguaí;2040;37418;2014;39432;94,89
3500402;Águas da Prata;2040;7257;337;7594;95,56
3500501;Águas de Lindóia;2040;18693;169;18862;99,1
3500550;Águas de Santa Bárbara;2040;5015;1185;6200;80,89
3500600;Águas de São Pedro;2040;3311;0;3311;100
3500709;Agudos;2040;36117;995;37112;97,32
3500758;Alambari;2040;6178;636;6814;90,67
3500808;Alfredo Marcondes;2040;3566;144;3710;96,12
3500907;Altair;2040;3825;368;4193;91,22
3501004;Altinópolis;2040;14514;516;15030;96,57
3501103;Alto Alegre;2040;3434;285;3719;92,34
3501152;Alumínio;2040;16279;3131;19410;83,87
3501202;Álvares Florence;2040;2493;547;3040;82,01
3501301;Álvares Machado;2040;22145;1610;23755;93,22
3501400;Álvaro de Carvalho;2040;4159;1436;5595;74,33
3501509;Alvinlândia;2040;3190;187;3377;94,46
3501608;Americana;2040;246849;1159;248008;99,53
3501707;Américo Brasiliense;2040;45933;350;46283;99,24
3501806;Américo de Campos;2040;4942;458;5400;91,52
3501905;Amparo;2040;63829;6054;69883;91,34
3502002;Analândia;2040;4928;540;5468;90,12
3502101;Andradina;2040;52670;2378;55048;95,68
3502200;Angatuba;2040;21688;5383;27071;80,12
3502309;Anhembi;2040;6645;1247;7892;84,2
3502408;Anhumas;2040;3912;245;4157;94,11
3502507;Aparecida;2040;34732;512;35244;98,55
3502606;Aparecida d'Oeste;2040;3251;297;3548;91,63
3502705;Apiaí;2040;23425;2121;25546;91,7
3502754;Araçariguama;2040;25668;0;25668;100
3502804;Araçatuba;2040;185859;3655;189514;98,07
3502903;Araçoiaba da Serra;2040;26712;12150;38862;68,74
3503000;Aramina;2040;5513;116;5629;97,94
3503109;Arandu;2040;5617;517;6134;91,57
3503158;Arapeí;2040;1956;429;2385;82,01
3503208;Araraquara;2040;229028;6702;235730;97,16
3503307;Araras;2040;134082;5413;139495;96,12
3503356;Arco-Íris;2040;1217;383;1600;76,06
3503406;Arealva;2040;7532;763;8295;90,8
3503505;Areias;2040;2774;1363;4137;67,05
3503604;Areiópolis;2040;11099;386;11485;96,64
3503703;Ariranha;2040;9375;525;9900;94,7
3503802;Artur Nogueira;2040;55137;5761;60898;90,54
3503901;Arujá;2040;105084;3454;108538;96,82
3503950;Aspásia;2040;1352;277;1629;83
3504008;Assis;2040;100606;4592;105198;95,63
3504107;Atibaia;2040;146234;5361;151595;96,46
3504206;Auriflama;2040;13436;562;13998;95,99
3504305;Avaí;2040;3725;1822;5547;67,15
3504404;Avanhandava;2040;11143;2036;13179;84,55
3504503;Avaré;2040;87923;2149;90072;97,61
3504602;Bady Bassitt;2040;16169;1044;17213;93,93
3504701;Balbinos;2040;1185;2499;3684;32,17
3504800;Bálsamo;2040;7912;516;8428;93,88
3504909;Bananal;2040;10151;1031;11182;90,78
3505005;Barão de Antonina;2040;2529;1177;3706;68,24
3505104;Barbosa;2040;7164;1041;8205;87,31
3505203;Bariri;2040;34877;815;35692;97,72
3505302;Barra Bonita;2040;32332;561;32893;98,29
3505351;Barra do Chapéu;2040;1783;4274;6057;29,44
3505401;Barra do Turvo;2040;4698;3455;8153;57,62
3505500;Barretos;2040;115549;3631;119180;96,95
3505609;Barrinha;2040;36645;411;37056;98,89
3505708;Barueri;2040;293036;0;293036;100
3505807;Bastos;2040;18207;1592;19799;91,96
3505906;Batatais;2040;55135;7210;62345;88,44
3506003;Bauru;2040;365012;6209;371221;98,33
3506102;Bebedouro;2040;66340;2212;68552;96,77
3506201;Bento de Abreu;2040;3155;73;3228;97,74
3506300;Bernardino de Campos;2040;9907;670;10577;93,67
3506359;Bertioga;2040;83576;284;83860;99,66
3506409;Bilac;2040;7788;266;8054;96,7
3506508;Birigui;2040;126485;2917;129402;97,75
3506607;Biritiba Mirim;2040;33777;3894;37671;89,66
3506706;Boa Esperança do Sul;2040;14801;797;15598;94,89
3506805;Bocaina;2040;12894;632;13526;95,33
3506904;Bofete;2040;8083;4595;12678;63,76
3507001;Boituva;2040;63137;3981;67118;94,07
3507100;Bom Jesus dos Perdões;2040;27378;1537;28915;94,68
3507159;Bom Sucesso de Itararé;2040;3779;671;4450;84,92
3507209;Borá;2040;600;170;770;77,92
3507308;Boracéia;2040;4918;336;5254;93,6
3507407;Borborema;2040;14909;531;15440;96,56
3507456;Borebi;2040;2818;80;2898;97,24
3507506;Botucatu;2040;147306;4340;151646;97,14
3507605;Bragança Paulista;2040;175430;3075;178505;98,28
3507704;Braúna;2040;5891;192;6083;96,84
3507753;Brejo Alegre;2040;2633;251;2884;91,3
3507803;Brodowski;2040;26081;124;26205;99,53
3507902;Brotas;2040;23205;3068;26273;88,32
3508009;Buri;2040;19799;2620;22419;88,31
3508108;Buritama;2040;16637;439;17076;97,43
3508207;Buritizal;2040;3890;549;4439;87,63
3508306;Cabrália Paulista;2040;3745;480;4225;88,64
3508405;Cabreúva;2040;57056;3073;60129;94,89
3508504;Caçapava;2040;81651;13776;95427;85,56
3508603;Cachoeira Paulista;2040;29082;4493;33575;86,62
3508702;Caconde;2040;14781;4131;18912;78,16
3508801;Cafelândia;2040;16573;1033;17606;94,13
3508900;Caiabu;2040;3708;365;4073;91,04
3509007;Caieiras;2040;115042;1319;116361;98,87
3509106;Caiuá;2040;2320;3735;6055;38,32
3509205;Cajamar;2040;96887;895;97782;99,08
3509254;Cajati;2040;24157;7541;31698;76,21
3509304;Cajobi;2040;9704;375;10079;96,28
3509403;Cajuru;2040;25291;2767;28058;90,14
3509452;Campina do Monte Alegre;2040;5582;427;6009;92,89
3509502;Campinas;2040;1209081;21154;1230235;98,28
3509601;Campo Limpo Paulista;2040;90675;0;90675;100
3509700;Campos do Jordão;2040;51812;325;52137;99,38
3509809;Campos Novos Paulista;2040;4602;563;5165;89,1
3509908;Cananéia;2040;11554;1559;13113;88,11
3509957;Canas;2040;5741;132;5873;97,75
3510005;Cândido Mota;2040;27288;1294;28582;95,47
3510104;Cândido Rodrigues;2040;2307;213;2520;91,55
3510153;Canitar;2040;5645;265;5910;95,52
3510203;Capão Bonito;2040;42347;4810;47157;89,8
3510302;Capela do Alto;2040;23101;1967;25068;92,15
3510401;Capivari;2040;59242;1052;60294;98,26
3510500;Caraguatatuba;2040;126700;4068;130768;96,89
3510609;Carapicuíba;2040;423349;0;423349;100
3510708;Cardoso;2040;10425;769;11194;93,13
3510807;Casa Branca;2040;25510;4592;30102;84,75
3510906;Cássia dos Coqueiros;2040;2054;261;2315;88,73
3511003;Castilho;2040;17768;5776;23544;75,47
3511102;Catanduva;2040;114230;925;115155;99,2
3511201;Catiguá;2040;7186;479;7665;93,75
3511300;Cedral;2040;8261;1123;9384;88,03
3511409;Cerqueira César;2040;20187;949;21136;95,51
3511508;Cerquilho;2040;50936;2780;53716;94,82
3511607;Cesário Lange;2040;12576;6050;18626;67,52
3511706;Charqueada;2040;17505;1359;18864;92,8
3511904;Clementina;2040;9459;207;9666;97,86
3512001;Colina;2040;16459;575;17034;96,62
3512100;Colômbia;2040;4783;1190;5973;80,08
3512209;Conchal;2040;28924;587;29511;98,01
3512308;Conchas;2040;16420;1537;17957;91,44
3512407;Cordeirópolis;2040;25235;2860;28095;89,82
3512506;Coroados;2040;5840;513;6353;91,93
3512605;Coronel Macedo;2040;4173;523;4696;88,86
3512704;Corumbataí;2040;3082;935;4017;76,72
3512803;Cosmópolis;2040;78646;6036;84682;92,87
3512902;Cosmorama;2040;5551;851;6402;86,71
3513009;Cotia;2040;312438;0;312438;100
3513108;Cravinhos;2040;36359;230;36589;99,37
3513207;Cristais Paulista;2040;8581;606;9187;93,4
3513306;Cruzália;2040;1495;392;1887;79,23
3513405;Cruzeiro;2040;79613;1695;81308;97,92
3513504;Cubatão;2040;140922;0;140922;100
3513603;Cunha;2040;15840;5257;21097;75,08
3513702;Descalvado;2040;31223;1365;32588;95,81
3513801;Diadema;2040;418906;0;418906;100
3513850;Dirce Reis;2040;1464;166;1630;89,82
3513900;Divinolândia;2040;8957;1346;10303;86,94
3514007;Dobrada;2040;9826;224;10050;97,77
3514106;Dois Córregos;2040;29004;569;29573;98,08
3514205;Dolcinópolis;2040;1745;113;1858;93,92
3514304;Dourado;2040;7298;612;7910;92,26
3514403;Dracena;2040;41954;2750;44704;93,85
3514502;Duartina;2040;10633;525;11158;95,29
3514601;Dumont;2040;10513;68;10581;99,36
3514700;Echaporã;2040;5215;750;5965;87,43
3514809;Eldorado;2040;8283;8549;16832;49,21
3514908;Elias Fausto;2040;16983;1764;18747;90,59
3514924;Elisiário;2040;3405;221;3626;93,91
3514957;Embaúba;2040;2132;154;2286;93,26
3515004;Embu;2040;308736;0;308736;100
3515103;Embu-Guaçu;2040;73800;2022;75822;97,33
3515129;Emilianópolis;2040;2776;189;2965;93,63
3515152;Engenheiro Coelho;2040;20852;4766;25618;81,4
3515186;Espírito Santo do Pinhal;2040;39436;2349;41785;94,38
3515194;Espírito Santo do Turvo;2040;4769;807;5576;85,53
3515202;Estrela d'Oeste;2040;6988;657;7645;91,41
3515301;Estrela do Norte;2040;2545;155;2700;94,26
3515350;Euclides da Cunha Paulista;2040;6476;3323;9799;66,09
3515400;Fartura;2040;14144;1781;15925;88,82
3515509;Fernandópolis;2040;61766;1952;63718;96,94
3515608;Fernando Prestes;2040;5025;246;5271;95,33
3515657;Fernão;2040;1273;471;1744;72,99
3515707;Ferraz de Vasconcelos;2040;214436;10074;224510;95,51
3515806;Flora Rica;2040;1288;82;1370;94,01
3515905;Floreal;2040;2219;266;2485;89,3
3516002;Flórida Paulista;2040;8632;2308;10940;78,9
3516101;Florínia;2040;2382;147;2529;94,19
3516200;Franca;2040;352473;6299;358772;98,24
3516309;Francisco Morato;2040;207313;422;207735;99,8
3516408;Franco da Rocha;2040;165257;14121;179378;92,13
3516507;Gabriel Monteiro;2040;2323;129;2452;94,74
3516606;Gália;2040;4937;1044;5981;82,54
3516705;Garça;2040;37875;1891;39766;95,24
3516804;Gastão Vidigal;2040;5252;159;5411;97,06
3516853;Gavião Peixoto;2040;4552;213;4765;95,53
3516903;General Salgado;2040;9275;700;9975;92,98
3517000;Getulina;2040;9474;1323;10797;87,75
3517109;Glicério;2040;4017;835;4852;82,79
3517208;Guaiçara;2040;12700;540;13240;95,92
3517307;Guaimbê;2040;5461;264;5725;95,39
3517406;Guaíra;2040;37895;1191;39086;96,95
3517505;Guapiaçu;2040;21646;1631;23277;92,99
3517604;Guapiara;2040;8683;10088;18771;46,26
3517703;Guará;2040;21667;413;22080;98,13
3517802;Guaraçai;2040;6966;1011;7977;87,33
3517901;Guaraci;2040;11348;494;11842;95,83
3518008;Guarani d'Oeste;2040;1648;159;1807;91,2
3518107;Guarantã;2040;6287;262;6549;96
3518206;Guararapes;2040;31119;1326;32445;95,91
3518305;Guararema;2040;29373;4760;34133;86,05
3518404;Guaratinguetá;2040;115260;5332;120592;95,58
3518503;Guareí;2040;9702;7094;16796;57,76
3518602;Guariba;2040;41919;403;42322;99,05
3518701;Guarujá;2040;348461;67;348528;99,98
3518800;Guarulhos;2040;1506383;0;1506383;100
3518859;Guatapará;2040;7128;793;7921;89,99
3518909;Guzolândia;2040;5093;310;5403;94,26
3519006;Herculândia;2040;9505;480;9985;95,19
3519055;Holambra;2040;16988;846;17834;95,26
3519071;Hortolândia;2040;275731;0;275731;100
3519105;Iacanga;2040;11433;1106;12539;91,18
3519204;Iacri;2040;5311;519;5830;91,1
3519253;Iaras;2040;3414;4258;7672;44,5
3519303;Ibaté;2040;37697;1161;38858;97,01
3519402;Ibirá;2040;11961;777;12738;93,9
3519501;Ibirarema;2040;7970;408;8378;95,13
3519600;Ibitinga;2040;60092;1790;61882;97,11
3519709;Ibiúna;2040;33406;48514;81920;40,78
3519808;Icém;2040;7622;1023;8645;88,17
3519907;Iepê;2040;7863;290;8153;96,44
3520004;Igaraçu do Tietê;2040;24609;142;24751;99,43
3520103;Igarapava;2040;29441;954;30395;96,86
3520202;Igaratá;2040;9160;701;9861;92,89
3520301;Iguape;2040;27159;3478;30637;88,65
3520400;Ilhabela;2040;38284;265;38549;99,31
3520426;Ilha Comprida;2040;11986;0;11986;100
3520442;Ilha Solteira;2040;23141;1519;24660;93,84
3520509;Indaiatuba;2040;271967;2762;274729;98,99
3520608;Indiana;2040;4229;370;4599;91,95
3520707;Indiaporã;2040;3343;241;3584;93,28
3520806;Inúbia Paulista;2040;3871;227;4098;94,46
3520905;Ipaussu;2040;14741;735;15476;95,25
3521002;Iperó;2040;24822;15404;40226;61,71
3521101;Ipeúna;2040;9202;443;9645;95,41
3521150;Ipiguá;2040;4203;1618;5821;72,2
3521200;Iporanga;2040;3837;889;4726;81,19
3521309;Ipuã;2040;17318;402;17720;97,73
3521408;Iracemápolis;2040;26468;463;26931;98,28
3521507;Irapuã;2040;7500;503;8003;93,71
3521606;Irapuru;2040;4631;1920;6551;70,69
3521705;Itaberá;2040;15487;2254;17741;87,29
3521804;Itaí;2040;23105;6320;29425;78,52
3521903;Itajobi;2040;12654;1097;13751;92,02
3522000;Itaju;2040;3689;361;4050;91,09
3522109;Itanhaém;2040;112276;548;112824;99,51
3522158;Itaóca;2040;1732;1444;3176;54,53
3522208;Itapecerica da Serra;2040;191568;1601;193169;99,17
3522307;Itapetininga;2040;167755;10668;178423;94,02
3522406;Itapeva;2040;94720;3122;97842;96,81
3522505;Itapevi;2040;294780;0;294780;100
3522604;Itapira;2040;66319;3321;69640;95,23
3522653;Itapirapuã Paulista;2040;2670;2058;4728;56,47
3522703;Itápolis;2040;40022;1548;41570;96,28
3522802;Itaporanga;2040;13196;1585;14781;89,28
3522901;Itapuí;2040;15271;304;15575;98,05
3523008;Itapura;2040;4484;1127;5611;79,91
3523107;Itaquaquecetuba;2040;439949;0;439949;100
3523206;Itararé;2040;47497;3329;50826;93,45
3523305;Itariri;2040;16116;3777;19893;81,01
3523404;Itatiba;2040;119613;11564;131177;91,18
3523503;Itatinga;2040;23002;880;23882;96,32
3523602;Itirapina;2040;17878;867;18745;95,37
3523701;Itirapuã;2040;6091;609;6700;90,91
3523800;Itobi;2040;7139;205;7344;97,21
3523909;Itu;2040;178381;5558;183939;96,98
3524006;Itupeva;2040;74130;1900;76030;97,5
3524105;Ituverava;2040;37893;2356;40249;94,15
3524204;Jaborandi;2040;6327;244;6571;96,29
3524303;Jaboticabal;2040;72781;501;73282;99,32
3524402;Jacareí;2040;238116;3335;241451;98,62
3524501;Jaci;2040;7450;501;7951;93,7
3524600;Jacupiranga;2040;9558;7997;17555;54,45
3524709;Jaguariúna;2040;62289;1090;63379;98,28
3524808;Jales;2040;42224;2647;44871;94,1
3524907;Jambeiro;2040;3350;3646;6996;47,88
3525003;Jandira;2040;144088;0;144088;100
3525102;Jardinópolis;2040;47431;279;47710;99,42
3525201;Jarinu;2040;35713;1996;37709;94,71
3525300;Jaú;2040;156248;3015;159263;98,11
3525409;Jeriquara;2040;2865;222;3087;92,81
3525508;Joanópolis;2040;13139;0;13139;100
3525607;João Ramalho;2040;4275;324;4599;92,95
3525706;José Bonifácio;2040;36083;2478;38561;93,57
3525805;Júlio Mesquita;2040;4620;217;4837;95,51
3525854;Jumirim;2040;2994;810;3804;78,71
3525904;Jundiaí;2040;423936;8547;432483;98,02
3526001;Junqueirópolis;2040;19046;2248;21294;89,44
3526100;Juquiá;2040;13295;5813;19108;69,58
3526209;Juquitiba;2040;31684;1797;33481;94,63
3526308;Lagoinha;2040;3851;905;4756;80,97
3526407;Laranjal Paulista;2040;28045;2339;30384;92,3
3526506;Lavínia;2040;3887;4077;7964;48,81
3526605;Lavrinhas;2040;7605;281;7886;96,44
3526704;Leme;2040;108491;1901;110392;98,28
3526803;Lençóis Paulista;2040;68589;1169;69758;98,32
3526902;Limeira;2040;301126;5722;306848;98,14
3527009;Lindóia;2040;8562;0;8562;100
3527108;Lins;2040;74727;884;75611;98,83
3527207;Lorena;2040;88510;1929;90439;97,87
3527256;Lourdes;2040;1906;188;2094;91,02
3527306;Louveira;2040;57559;1043;58602;98,22
3527405;Lucélia;2040;19051;2363;21414;88,97
3527504;Lucianópolis;2040;1916;325;2241;85,5
3527603;Luís Antônio;2040;16883;75;16958;99,56
3527702;Luiziânia;2040;6342;193;6535;97,05
3527801;Lupércio;2040;4257;200;4457;95,51
3527900;Lutécia;2040;2232;261;2493;89,53
3528007;Macatuba;2040;17120;307;17427;98,24
3528106;Macaubal;2040;6716;516;7232;92,87
3528205;Macedônia;2040;2755;479;3234;85,19
3528304;Magda;2040;2509;307;2816;89,1
3528403;Mairinque;2040;39716;9769;49485;80,26
3528502;Mairiporã;2040;114988;3778;118766;96,82
3528601;Manduri;2040;9557;279;9836;97,16
3528700;Marabá Paulista;2040;2242;2794;5036;44,52
3528809;Maracaí;2040;12476;747;13223;94,35
3528858;Marapoama;2040;2847;199;3046;93,47
3528908;Mariápolis;2040;3649;296;3945;92,5
3529005;Marília;2040;228891;10751;239642;95,51
3529104;Marinópolis;2040;1734;256;1990;87,14
3529203;Martinópolis;2040;24234;2339;26573;91,2
3529302;Matão;2040;78254;1463;79717;98,16
3529401;Mauá;2040;500134;0;500134;100
3529500;Mendonça;2040;4650;415;5065;91,81
3529609;Meridiano;2040;2635;754;3389;77,75
3529658;Mesópolis;2040;1723;140;1863;92,49
3529708;Miguelópolis;2040;21646;672;22318;96,99
3529807;Mineiros do Tietê;2040;12494;584;13078;95,53
3529906;Miracatu;2040;12242;8504;20746;59,01
3530003;Mira Estrela;2040;1945;971;2916;66,7
3530102;Mirandópolis;2040;27335;1614;28949;94,42
3530201;Mirante do Paranapanema;2040;10750;7506;18256;58,88
3530300;Mirassol;2040;58371;1513;59884;97,47
3530409;Mirassolândia;2040;4172;959;5131;81,31
3530508;Mococa;2040;62414;1688;64102;97,37
3530607;Mogi das Cruzes;2040;462231;30456;492687;93,82
3530706;Mogi-Guaçu;2040;150913;4439;155352;97,14
3530805;Moji Mirim;2040;88568;2217;90785;97,56
3530904;Mombuca;2040;3221;173;3394;94,9
3531001;Monções;2040;1852;227;2079;89,08
3531100;Mongaguá;2040;63670;279;63949;99,56
3531209;Monte Alegre do Sul;2040;5791;2304;8095;71,54
3531308;Monte Alto;2040;46585;727;47312;98,46
3531407;Monte Aprazível;2040;22299;1478;23777;93,78
3531506;Monte Azul Paulista;2040;16137;564;16701;96,62
3531605;Monte Castelo;2040;3341;372;3713;89,98
3531704;Monteiro Lobato;2040;2228;2518;4746;46,94
3531803;Monte Mor;2040;71924;2093;74017;97,17
3531902;Morro Agudo;2040;35882;658;36540;98,2
3532009;Morungaba;2040;13943;708;14651;95,17
3532058;Motuca;2040;4391;522;4913;89,38
3532108;Murutinga do Sul;2040;2502;1569;4071;61,46
3532157;Nantes;2040;3469;78;3547;97,8
3532207;Narandiba;2040;5069;464;5533;91,61
3532306;Natividade da Serra;2040;2946;3766;6712;43,89
3532405;Nazaré Paulista;2040;20343;361;20704;98,26
3532504;Neves Paulista;2040;7298;513;7811;93,43
3532603;Nhandeara;2040;8664;1159;9823;88,2
3532702;Nipoã;2040;5175;406;5581;92,73
3532801;Nova Aliança;2040;6176;556;6732;91,74
3532827;Nova Campina;2040;10618;877;11495;92,37
3532843;Nova Canaã Paulista;2040;1072;528;1600;67
3532868;Nova Castilho;2040;1113;82;1195;93,14
3532900;Nova Europa;2040;11768;414;12182;96,6
3533007;Nova Granada;2040;21085;1365;22450;93,92
3533106;Nova Guataporanga;2040;1965;130;2095;93,79
3533205;Nova Independência;2040;3967;354;4321;91,81
3533254;Novais;2040;6050;393;6443;93,9
3533304;Nova Lusitânia;2040;4444;148;4592;96,78
3533403;Nova Odessa;2040;62127;1029;63156;98,37
3533502;Novo Horizonte;2040;37583;2430;40013;93,93
3533601;Nuporanga;2040;7284;162;7446;97,82
3533700;Ocauçu;2040;3720;294;4014;92,68
3533809;Óleo;2040;1871;431;2302;81,28
3533908;Olímpia;2040;51617;1892;53509;96,46
3534005;Onda Verde;2040;4126;389;4515;91,38
3534104;Oriente;2040;5962;281;6243;95,5
3534203;Orindiúva;2040;7500;491;7991;93,86
3534302;Orlândia;2040;42426;1122;43548;97,42
3534401;Osasco;2040;707592;0;707592;100
3534500;Oscar Bressane;2040;2123;168;2291;92,67
3534609;Osvaldo Cruz;2040;27749;1944;29693;93,45
3534708;Ourinhos;2040;113743;3015;116758;97,42
3534757;Ouroeste;2040;10395;674;11069;93,91
3534807;Ouro Verde;2040;8438;312;8750;96,43
3534906;Pacaembu;2040;9223;3294;12517;73,68
3535002;Palestina;2040;11214;1281;12495;89,75
3535101;Palmares Paulista;2040;14823;440;15263;97,12
3535200;Palmeira d'Oeste;2040;7271;971;8242;88,22
3535309;Palmital;2040;20092;955;21047;95,46
3535408;Panorama;2040;15571;325;15896;97,96
3535507;Paraguaçu Paulista;2040;40804;4222;45026;90,62
3535606;Paraibuna;2040;5835;13520;19355;30,15
3535705;Paraíso;2040;6042;436;6478;93,27
3535804;Paranapanema;2040;20981;1725;22706;92,4
3535903;Paranapuã;2040;3539;247;3786;93,48
3536000;Parapuã;2040;8780;848;9628;91,19
3536109;Pardinho;2040;7374;261;7635;96,58
3536208;Pariquera-Açu;2040;14968;5167;20135;74,34
3536257;Parisi;2040;1727;240;1967;87,8
3536307;Patrocínio Paulista;2040;14993;1470;16463;91,07
3536406;Paulicéia;2040;7660;400;8060;95,04
3536505;Paulínia;2040;127661;118;127779;99,91
3536570;Paulistânia;2040;1545;170;1715;90,09
3536604;Paulo de Faria;2040;7824;576;8400;93,14
3536703;Pederneiras;2040;45572;3430;49002;93
3536802;Pedra Bela;2040;2213;3746;5959;37,14
3536901;Pedranópolis;2040;1466;715;2181;67,22
3537008;Pedregulho;2040;12913;3929;16842;76,67
3537107;Pedreira;2040;50453;427;50880;99,16
3537156;Pedrinhas Paulista;2040;2689;272;2961;90,81
3537206;Pedro de Toledo;2040;8967;3173;12140;73,86
3537305;Penápolis;2040;59315;1323;60638;97,82
3537404;Pereira Barreto;2040;23672;1360;25032;94,57
3537503;Pereiras;2040;6224;3095;9319;66,79
3537602;Peruíbe;2040;74953;161;75114;99,79
3537701;Piacatu;2040;6161;262;6423;95,92
3537800;Piedade;2040;27343;27010;54353;50,31
3537909;Pilar do Sul;2040;26947;3008;29955;89,96
3538006;Pindamonhangaba;2040;172679;3830;176509;97,83
3538105;Pindorama;2040;15718;888;16606;94,65
3538204;Pinhalzinho;2040;8423;7610;16033;52,54
3538303;Piquerobi;2040;2937;466;3403;86,31
3538501;Piquete;2040;12247;762;13009;94,14
3538600;Piracaia;2040;26969;0;26969;100
3538709;Piracicaba;2040;393804;6910;400714;98,28
3538808;Piraju;2040;26239;1346;27585;95,12
3538907;Pirajuí;2040;19092;3905;22997;83,02
3539004;Pirangi;2040;9855;560;10415;94,62
3539103;Pirapora do Bom Jesus;2040;23627;0;23627;100
3539202;Pirapozinho;2040;28889;896;29785;96,99
3539301;Pirassununga;2040;71380;2899;74279;96,1
3539400;Piratininga;2040;12805;1342;14147;90,51
3539509;Pitangueiras;2040;41940;485;42425;98,86
3539608;Planalto;2040;5492;447;5939;92,47
3539707;Platina;2040;3477;465;3942;88,2
3539806;Poá;2040;123840;1988;125828;98,42
3539905;Poloni;2040;5066;626;5692;89
3540002;Pompéia;2040;21043;1191;22234;94,64
3540101;Pongaí;2040;2842;207;3049;93,21
3540200;Pontal;2040;57939;254;58193;99,56
3540259;Pontalinda;2040;4446;391;4837;91,92
3540309;Pontes Gestal;2040;2319;183;2502;92,69
3540408;Populina;2040;3149;422;3571;88,18
3540507;Porangaba;2040;4843;5187;10030;48,29
3540606;Porto Feliz;2040;49026;4516;53542;91,57
3540705;Porto Ferreira;2040;54550;996;55546;98,21
3540754;Potim;2040;16789;5351;22140;75,83
3540804;Potirendaba;2040;15977;1108;17085;93,51
3540853;Pracinha;2040;1426;1553;2979;47,87
3540903;Pradópolis;2040;23128;1378;24506;94,38
3541000;Praia Grande;2040;373470;0;373470;100
3541059;Pratânia;2040;5354;623;5977;89,58
3541109;Presidente Alves;2040;3545;238;3783;93,71
3541208;Presidente Bernardes;2040;11874;1100;12974;91,52
3541307;Presidente Epitácio;2040;40704;2126;42830;95,04
3541406;Presidente Prudente;2040;221538;4613;226151;97,96
3541505;Presidente Venceslau;2040;35743;802;36545;97,81
3541604;Promissão;2040;39524;4966;44490;88,84
3541653;Quadra;2040;1118;3094;4212;26,54
3541703;Quatá;2040;14436;687;15123;95,46
3541802;Queiroz;2040;3639;230;3869;94,06
3541901;Queluz;2040;11283;2474;13757;82,02
3542008;Quitana;2040;6531;437;6968;93,73
3542107;Rafard;2040;8834;659;9493;93,06
3542206;Rancharia;2040;26899;1520;28419;94,65
3542305;Redenção da Serra;2040;3352;370;3722;90,06
3542404;Regente Feijó;2040;19087;799;19886;95,98
3542503;Reginópolis;2040;4120;2797;6917;59,56
3542602;Registro;2040;49060;6205;55265;88,77
3542701;Restinga;2040;7697;1027;8724;88,23
3542800;Ribeira;2040;2061;1173;3234;63,73
3542909;Ribeirão Bonito;2040;13568;499;14067;96,45
3543006;Ribeirão Branco;2040;13029;4524;17553;74,23
3543105;Ribeirão Corrente;2040;4564;628;5192;87,9
3543204;Ribeirão do Sul;2040;3683;385;4068;90,54
3543238;Ribeirão dos Índios;2040;1873;129;2002;93,56
3543253;Ribeirão Grande;2040;2464;5249;7713;31,95
3543303;Ribeirão Pires;2040;121068;0;121068;100
3543402;Ribeirão Preto;2040;735536;2093;737629;99,72
3543501;Riversul;2040;4385;1087;5472;80,14
3543600;Rifaina;2040;3074;311;3385;90,81
3543709;Rincão;2040;8925;1615;10540;84,68
3543808;Rinópolis;2040;8645;475;9120;94,79
3543907;Rio Claro;2040;206695;4034;210729;98,09
3544004;Rio das Pedras;2040;38436;687;39123;98,24
3544103;Rio Grande da Serra;2040;56804;0;56804;100
3544202;Riolândia;2040;9903;2614;12517;79,12
3544251;Rosana;2040;17007;356;17363;97,95
3544301;Roseira;2040;11376;337;11713;97,12
3544400;Rubiácea;2040;2341;1213;3554;65,87
3544509;Rubinéia;2040;2707;226;2933;92,29
3544608;Sabino;2040;5321;260;5581;95,34
3544707;Sagres;2040;2132;157;2289;93,14
3544806;Sales;2040;5927;385;6312;93,9
3544905;Sales Oliveira;2040;11735;340;12075;97,18
3545001;Salesópolis;2040;13212;5293;18505;71,4
3545100;Salmourão;2040;5146;148;5294;97,2
3545159;Saltinho;2040;6768;1217;7985;84,76
3545209;Salto;2040;122417;867;123284;99,3
3545308;Salto de Pirapora;2040;37944;9884;47828;79,33
3545407;Salto Grande;2040;8969;558;9527;94,14
3545506;Sandovalina;2040;4451;405;4856;91,66
3545605;Santa Adélia;2040;14194;809;15003;94,61
3545704;Santa Albertina;2040;4789;389;5178;92,49
3545803;Santa Bárbara d'Oeste;2040;189625;1500;191125;99,22
3546009;Santa Branca;2040;12672;1694;14366;88,21
3546108;Santa Clara d'Oeste;2040;1593;234;1827;87,19
3546207;Santa Cruz da Conceição;2040;4071;417;4488;90,71
3546256;Santa Cruz da Esperança;2040;1556;638;2194;70,92
3546306;Santa Cruz das Palmeiras;2040;36945;664;37609;98,23
3546405;Santa Cruz do Rio Pardo;2040;45663;2278;47941;95,25
3546504;Santa Ernestina;2040;5301;157;5458;97,12
3546603;Santa Fé do Sul;2040;29558;1211;30769;96,06
3546702;Santa Gertrudes;2040;31801;342;32143;98,94
3546801;Santa Isabel;2040;51224;8518;59742;85,74
3546900;Santa Lucia;2040;8707;274;8981;96,95
3547007;Santa Maria da Serra;2040;6865;402;7267;94,47
3547106;Santa Mercedes;2040;2710;117;2827;95,86
3547205;Santana da Ponte Pensa;2040;1063;204;1267;83,9
3547304;Santana de Parnaíba;2040;178709;0;178709;100
3547403;Santa Rita d'Oeste;2040;1814;230;2044;88,75
3547502;Santa Rita do Passa Quatro;2040;23930;1311;25241;94,81
3547601;Santa Rosa do Viterbo;2040;25984;664;26648;97,51
3547650;Santa Salete;2040;1160;161;1321;87,81
3547700;Santo Anastácio;2040;18701;820;19521;95,8
3547809;Santo André;2040;685195;0;685195;100
3547908;Santo Antonio da Alegria;2040;5219;1497;6716;77,71
3548005;Santo Antonio da Posse;2040;24614;523;25137;97,92
3548054;Santo Antonio do Aracanguá;2040;8203;437;8640;94,94
3548104;Santo Antonio do Jardim;2040;4276;1380;5656;75,6
3548203;Santo Antonio do Pinhal;2040;5790;1034;6824;84,85
3548302;Santo Expedito;2040;3038;95;3133;96,97
3548401;Santópolis do Aguapeí;2040;4928;100;5028;98,01
3548500;Santos;2040;434500;326;434826;99,93
3548609;São Bento do Sapucaí;2040;6068;4313;10381;58,45
3548708;São Bernardo do Campo;2040;825356;12519;837875;98,51
3548807;São Caetano do Sul;2040;142214;0;142214;100
3548906;São Carlos;2040;244620;10206;254826;95,99
3549003;São Francisco;2040;2154;293;2447;88,03
3549102;São João da Boa Vista;2040;84430;1602;86032;98,14
3549201;São João das Duas Pontes;2040;1771;490;2261;78,33
3549250;São João de Iracema;2040;1750;76;1826;95,84
3549300;São João do Pau d'Alho;2040;1609;123;1732;92,9
3549409;São Joaquim da Barra;2040;52166;933;53099;98,24
3549508;São José da Bela Vista;2040;8685;533;9218;94,22
3549607;São José do Barreiro;2040;3685;412;4097;89,94
3549706;São José do Rio Pardo;2040;50495;2123;52618;95,97
3549805;São José do Rio Preto;2040;436192;28172;464364;93,93
3549904;São José dos Campos;2040;770840;16007;786847;97,97
3549953;São Lourenço da Serra;2040;16861;743;17604;95,78
3550001;São Luís do Paraitinga;2040;6497;4157;10654;60,98
3550100;São Manuel;2040;40033;419;40452;98,96
3550209;São Miguel Arcanjo;2040;29985;3936;33921;88,4
3550308;São Paulo;2040;12243639;111058;12354697;99,1
3550407;São Pedro;2040;33209;3125;36334;91,4
3550506;São Pedro do Turvo;2040;6498;1009;7507;86,56
3550605;São Roque;2040;92461;1098;93559;98,83
3550704;São Sebastião;2040;101692;1159;102851;98,87
3550803;São Sebastião da Grama;2040;9229;2324;11553;79,88
3550902;São Simão;2040;14429;691;15120;95,43
3551009;São Vicente;2040;386035;731;386766;99,81
3551108;Sarapuí;2040;10346;1190;11536;89,68
3551207;Sarutaiá;2040;3423;274;3697;92,59
3551306;Sebastianópolis do Sul;2040;3017;267;3284;91,87
3551405;Serra Azul;2040;9740;3935;13675;71,22
3551504;Serrana;2040;50189;161;50350;99,68
3551603;Serra Negra;2040;23730;3321;27051;87,72
3551702;Sertãozinho;2040;130296;382;130678;99,71
3551801;Sete Barras;2040;11250;1822;13072;86,06
3551900;Severínia;2040;18328;579;18907;96,94
3552007;Silveiras;2040;4127;2549;6676;61,82
3552106;Socorro;2040;30348;8604;38952;77,91
3552205;Sorocaba;2040;708168;7281;715449;98,98
3552304;Sud Mennucci;2040;6766;1051;7817;86,55
3552403;Sumaré;2040;325742;3881;329623;98,82
3552502;Suzano;2040;316123;11534;327657;96,48
3552551;Suzanópolis;2040;3028;1508;4536;66,75
3552601;Tabapuã;2040;11121;719;11840;93,93
3552700;Tabatinga;2040;16181;870;17051;94,9
3552809;Taboão da Serra;2040;335902;0;335902;100
3552908;Taciba;2040;5852;504;6356;92,07
3553005;Taguaí;2040;11471;4542;16013;71,64
3553104;Taiaçu;2040;5781;258;6039;95,73
3553203;Taiúva;2040;5601;227;5828;96,11
3553302;Tambaú;2040;21821;1237;23058;94,64
3553401;Tanabi;2040;23090;1502;24592;93,89
3553500;Tapiraí;2040;6381;1459;7840;81,39
3553609;Tapiratiba;2040;11668;498;12166;95,91
3553658;Taquaral;2040;2668;59;2727;97,84
3553708;Taquaritinga;2040;51783;1601;53384;97
3553807;Taquarituba;2040;22539;1133;23672;95,21
3553856;Taquarivaí;2040;4310;2343;6653;64,78
3553906;Tarabaí;2040;7718;325;8043;95,96
3553955;Tarumã;2040;16039;757;16796;95,49
3554003;Tatuí;2040;133740;1975;135715;98,54
3554102;Taubaté;2040;321890;6684;328574;97,97
3554201;Tejupá;2040;4388;453;4841;90,64
3554300;Teodoro Sampaio;2040;19958;3430;23388;85,33
3554409;Terra Roxa;2040;9404;309;9713;96,82
3554508;Tietê;2040;42044;3553;45597;92,21
3554607;Timburi;2040;2038;339;2377;85,74
3554656;Torre de Pedra;2040;1891;444;2335;80,99
3554706;Torrinha;2040;8783;888;9671;90,82
3554755;Trabiju;2040;1776;80;1856;95,69
3554805;Tremembé;2040;48637;1999;50636;96,05
3554904;Três Fronteiras;2040;4970;426;5396;92,11
3554953;Tuiuti;2040;4337;2605;6942;62,47
3555000;Tupã;2040;56702;2369;59071;95,99
3555109;Tupi Paulista;2040;11114;3037;14151;78,54
3555208;Turiúba;2040;1541;191;1732;88,97
3555307;Turmalina;2040;1246;249;1495;83,34
3555356;Ubarana;2040;6442;460;6902;93,34
3555406;Ubatuba;2040;98094;2236;100330;97,77
3555505;Ubirajara;2040;3687;1209;4896;75,31
3555604;Uchôa;2040;8810;569;9379;93,93
3555703;União Paulista;2040;1656;269;1925;86,03
3555802;Urânia;2040;7106;724;7830;90,75
3555901;Uru;2040;1100;25;1125;97,78
3556008;Urupês;2040;12083;829;12912;93,58
3556107;Valentim Gentil;2040;13293;884;14177;93,76
3556206;Valinhos;2040;131082;4943;136025;96,37
3556305;Valparaíso;2040;24868;500;25368;98,03
3556354;Vargem;2040;9072;1955;11027;82,27
3556404;Vargem Grande do Sul;2040;42358;1080;43438;97,51
3556453;Vargem Grande Paulista;2040;67367;0;67367;100
3556503;Várzea Paulista;2040;132684;0;132684;100
3556602;Vera Cruz;2040;9371;687;10058;93,17
3556701;Vinhedo;2040;85821;2784;88605;96,86
3556800;Viradouro;2040;18723;564;19287;97,08
3556909;Vista Alegre do Alto;2040;8624;313;8937;96,5
3556958;Vitória Brasil;2040;1571;119;1690;92,96
3557006;Votorantim;2040;125278;4968;130246;96,19
3557105;Votuporanga;2040;90259;2602;92861;97,2
3557154;Zacarias;2040;2467;232;2699;91,4
3557204;Chavantes;2040;11656;565;12221;95,38
3557303;Estiva Gerbi;2040;9463;2401;11864;79,76
3500105;Adamantina;2045;30941;715;31656;97,74
3500204;Adolfo;2045;2841;187;3028;93,82
3500303;Aguaí;2045;37828;1841;39669;95,36
3500402;Águas da Prata;2045;7104;291;7395;96,06
3500501;Águas de Lindóia;2045;18586;168;18754;99,1
3500550;Águas de Santa Bárbara;2045;5042;1136;6178;81,61
3500600;Águas de São Pedro;2045;3298;0;3298;100
3500709;Agudos;2045;35952;931;36883;97,48
3500758;Alambari;2045;6342;544;6886;92,1
3500808;Alfredo Marcondes;2045;3480;119;3599;96,69
3500907;Altair;2045;3840;322;4162;92,26
3501004;Altinópolis;2045;14357;409;14766;97,23
3501103;Alto Alegre;2045;3369;236;3605;93,45
3501152;Alumínio;2045;16353;3145;19498;83,87
3501202;Álvares Florence;2045;2402;472;2874;83,58
3501301;Álvares Machado;2045;21877;1493;23370;93,61
3501400;Álvaro de Carvalho;2045;4303;1369;5672;75,86
3501509;Alvinlândia;2045;3218;179;3397;94,73
3501608;Americana;2045;243385;1142;244527;99,53
3501707;Américo Brasiliense;2045;46442;354;46796;99,24
3501806;Américo de Campos;2045;4814;416;5230;92,05
3501905;Amparo;2045;63329;5128;68457;92,51
3502002;Analândia;2045;5011;481;5492;91,24
3502101;Andradina;2045;51819;2193;54012;95,94
3502200;Angatuba;2045;22079;5082;27161;81,29
3502309;Anhembi;2045;6840;1174;8014;85,35
3502408;Anhumas;2045;3909;207;4116;94,97
3502507;Aparecida;2045;34282;506;34788;98,55
3502606;Aparecida d'Oeste;2045;3136;265;3401;92,21
3502705;Apiaí;2045;23940;1734;25674;93,25
3502754;Araçariguama;2045;26249;0;26249;100
3502804;Araçatuba;2045;182032;3580;185612;98,07
3502903;Araçoiaba da Serra;2045;27173;12360;39533;68,73
3503000;Aramina;2045;5456;109;5565;98,04
3503109;Arandu;2045;5654;427;6081;92,98
3503158;Arapeí;2045;1941;398;2339;82,98
3503208;Araraquara;2045;225931;6611;232542;97,16
3503307;Araras;2045;133160;5112;138272;96,3
3503356;Arco-Íris;2045;1207;332;1539;78,43
3503406;Arealva;2045;7512;655;8167;91,98
3503505;Areias;2045;2794;1374;4168;67,03
3503604;Areiópolis;2045;11169;327;11496;97,16
3503703;Ariranha;2045;9329;522;9851;94,7
3503802;Artur Nogueira;2045;55526;5801;61327;90,54
3503901;Arujá;2045;107763;3412;111175;96,93
3503950;Aspásia;2045;1330;245;1575;84,44
3504008;Assis;2045;99716;4551;104267;95,64
3504107;Atibaia;2045;147053;4788;151841;96,85
3504206;Auriflama;2045;13142;495;13637;96,37
3504305;Avaí;2045;3700;1810;5510;67,15
3504404;Avanhandava;2045;11224;2050;13274;84,56
3504503;Avaré;2045;87319;1964;89283;97,8
3504602;Bady Bassitt;2045;15952;1030;16982;93,93
3504701;Balbinos;2045;1176;2482;3658;32,15
3504800;Bálsamo;2045;7734;502;8236;93,9
3504909;Bananal;2045;10289;911;11200;91,87
3505005;Barão de Antonina;2045;2580;1142;3722;69,32
3505104;Barbosa;2045;7285;1020;8305;87,72
3505203;Bariri;2045;34606;753;35359;97,87
3505302;Barra Bonita;2045;31352;540;31892;98,31
3505351;Barra do Chapéu;2045;1813;4343;6156;29,45
3505401;Barra do Turvo;2045;4967;3290;8257;60,16
3505500;Barretos;2045;113595;3569;117164;96,95
3505609;Barrinha;2045;37158;417;37575;98,89
3505708;Barueri;2045;297664;0;297664;100
3505807;Bastos;2045;17999;1459;19458;92,5
3505906;Batatais;2045;54407;7115;61522;88,44
3506003;Bauru;2045;359677;6119;365796;98,33
3506102;Bebedouro;2045;64194;2102;66296;96,83
3506201;Bento de Abreu;2045;3168;69;3237;97,87
3506300;Bernardino de Campos;2045;9784;625;10409;94
3506359;Bertioga;2045;86919;236;87155;99,73
3506409;Bilac;2045;7705;237;7942;97,02
3506508;Birigui;2045;125259;2813;128072;97,8
3506607;Biritiba Mirim;2045;34611;3762;38373;90,2
3506706;Boa Esperança do Sul;2045;14863;729;15592;95,32
3506805;Bocaina;2045;12958;586;13544;95,67
3506904;Bofete;2045;8184;4653;12837;63,75
3507001;Boituva;2045;63937;4032;67969;94,07
3507100;Bom Jesus dos Perdões;2045;27940;1386;29326;95,27
3507159;Bom Sucesso de Itararé;2045;3964;601;4565;86,83
3507209;Borá;2045;583;165;748;77,94
3507308;Boracéia;2045;4971;314;5285;94,06
3507407;Borborema;2045;14708;492;15200;96,76
3507456;Borebi;2045;2845;70;2915;97,6
3507506;Botucatu;2045;147018;4166;151184;97,24
3507605;Bragança Paulista;2045;175307;3069;178376;98,28
3507704;Braúna;2045;5931;169;6100;97,23
3507753;Brejo Alegre;2045;2631;221;2852;92,25
3507803;Brodowski;2045;26015;107;26122;99,59
3507902;Brotas;2045;23331;2989;26320;88,64
3508009;Buri;2045;20486;2464;22950;89,26
3508108;Buritama;2045;16438;404;16842;97,6
3508207;Buritizal;2045;3902;511;4413;88,42
3508306;Cabrália Paulista;2045;3720;461;4181;88,97
3508405;Cabreúva;2045;58539;2683;61222;95,62
3508504;Caçapava;2045;81192;13699;94891;85,56
3508603;Cachoeira Paulista;2045;29063;4226;33289;87,31
3508702;Caconde;2045;14869;3820;18689;79,56
3508801;Cafelândia;2045;16579;909;17488;94,8
3508900;Caiabu;2045;3705;321;4026;92,03
3509007;Caieiras;2045;116264;1257;117521;98,93
3509106;Caiuá;2045;2302;3707;6009;38,31
3509205;Cajamar;2045;100108;917;101025;99,09
3509254;Cajati;2045;24682;7504;32186;76,69
3509304;Cajobi;2045;9547;352;9899;96,44
3509403;Cajuru;2045;25479;2731;28210;90,32
3509452;Campina do Monte Alegre;2045;5642;376;6018;93,75
3509502;Campinas;2045;1198199;20964;1219163;98,28
3509601;Campo Limpo Paulista;2045;90390;0;90390;100
3509700;Campos do Jordão;2045;51900;326;52226;99,38
3509809;Campos Novos Paulista;2045;4673;510;5183;90,16
3509908;Cananéia;2045;11695;1554;13249;88,27
3509957;Canas;2045;5827;128;5955;97,85
3510005;Cândido Mota;2045;26587;1255;27842;95,49
3510104;Cândido Rodrigues;2045;2260;183;2443;92,51
3510153;Canitar;2045;5746;270;6016;95,51
3510203;Capão Bonito;2045;42482;4335;46817;90,74
3510302;Capela do Alto;2045;23854;1765;25619;93,11
3510401;Capivari;2045;59479;1047;60526;98,27
3510500;Caraguatatuba;2045;128600;3973;132573;97
3510609;Carapicuíba;2045;426766;0;426766;100
3510708;Cardoso;2045;10200;733;10933;93,3
3510807;Casa Branca;2045;25459;4426;29885;85,19
3510906;Cássia dos Coqueiros;2045;2047;209;2256;90,74
3511003;Castilho;2045;17835;5798;23633;75,47
3511102;Catanduva;2045;111559;903;112462;99,2
3511201;Catiguá;2045;7072;467;7539;93,81
3511300;Cedral;2045;8279;1033;9312;88,91
3511409;Cerqueira César;2045;20471;841;21312;96,05
3511508;Cerquilho;2045;51356;2802;54158;94,83
3511607;Cesário Lange;2045;12608;6066;18674;67,52
3511706;Charqueada;2045;17656;1312;18968;93,08
3511904;Clementina;2045;9597;202;9799;97,94
3512001;Colina;2045;16193;547;16740;96,73
3512100;Colômbia;2045;4827;1120;5947;81,17
3512209;Conchal;2045;29119;562;29681;98,11
3512308;Conchas;2045;16581;1342;17923;92,51
3512407;Cordeirópolis;2045;25498;2890;28388;89,82
3512506;Coroados;2045;5849;444;6293;92,94
3512605;Coronel Macedo;2045;4176;456;4632;90,16
3512704;Corumbataí;2045;3167;812;3979;79,59
3512803;Cosmópolis;2045;79459;6098;85557;92,87
3512902;Cosmorama;2045;5453;729;6182;88,21
3513009;Cotia;2045;322876;0;322876;100
3513108;Cravinhos;2045;36221;195;36416;99,46
3513207;Cristais Paulista;2045;8682;488;9170;94,68
3513306;Cruzália;2045;1471;349;1820;80,82
3513405;Cruzeiro;2045;79008;1668;80676;97,93
3513504;Cubatão;2045;141198;0;141198;100
3513603;Cunha;2045;16152;4651;20803;77,64
3513702;Descalvado;2045;30745;1227;31972;96,16
3513801;Diadema;2045;420116;0;420116;100
3513850;Dirce Reis;2045;1443;146;1589;90,81
3513900;Divinolândia;2045;8961;1119;10080;88,9
3514007;Dobrada;2045;9930;226;10156;97,77
3514106;Dois Córregos;2045;29258;547;29805;98,16
3514205;Dolcinópolis;2045;1686;109;1795;93,93
3514304;Dourado;2045;7118;586;7704;92,39
3514403;Dracena;2045;41143;2599;43742;94,06
3514502;Duartina;2045;10427;458;10885;95,79
3514601;Dumont;2045;10474;56;10530;99,47
3514700;Echaporã;2045;5176;684;5860;88,33
3514809;Eldorado;2045;8399;8669;17068;49,21
3514908;Elias Fausto;2045;17195;1555;18750;91,71
3514924;Elisiário;2045;3369;218;3587;93,92
3514957;Embaúba;2045;2100;136;2236;93,92
3515004;Embu;2045;313865;0;313865;100
3515103;Embu-Guaçu;2045;74644;2045;76689;97,33
3515129;Emilianópolis;2045;2733;159;2892;94,5
3515152;Engenheiro Coelho;2045;21597;4568;26165;82,54
3515186;Espírito Santo do Pinhal;2045;38768;2073;40841;94,92
3515194;Espírito Santo do Turvo;2045;4846;820;5666;85,53
3515202;Estrela d'Oeste;2045;6854;598;7452;91,98
3515301;Estrela do Norte;2045;2545;129;2674;95,18
3515350;Euclides da Cunha Paulista;2045;6501;3281;9782;66,46
3515400;Fartura;2045;14188;1597;15785;89,88
3515509;Fernandópolis;2045;60163;1901;62064;96,94
3515608;Fernando Prestes;2045;4907;212;5119;95,86
3515657;Fernão;2045;1315;427;1742;75,49
3515707;Ferraz de Vasconcelos;2045;217631;10224;227855;95,51
3515806;Flora Rica;2045;1252;67;1319;94,92
3515905;Floreal;2045;2130;235;2365;90,06
3516002;Flórida Paulista;2045;8429;2254;10683;78,9
3516101;Florínia;2045;2337;136;2473;94,5
3516200;Franca;2045;350128;6257;356385;98,24
3516309;Francisco Morato;2045;212837;434;213271;99,8
3516408;Franco da Rocha;2045;168972;14438;183410;92,13
3516507;Gabriel Monteiro;2045;2256;106;2362;95,51
3516606;Gália;2045;4840;950;5790;83,59
3516705;Garça;2045;36998;1805;38803;95,35
3516804;Gastão Vidigal;2045;5340;144;5484;97,37
3516853;Gavião Peixoto;2045;4549;186;4735;96,07
3516903;General Salgado;2045;9057;605;9662;93,74
3517000;Getulina;2045;9520;1182;10702;88,96
3517109;Glicério;2045;4054;772;4826;84
3517208;Guaiçara;2045;12830;486;13316;96,35
3517307;Guaimbê;2045;5489;229;5718;96
3517406;Guaíra;2045;37204;1169;38373;96,95
3517505;Guapiaçu;2045;21683;1572;23255;93,24
3517604;Guapiara;2045;8947;9976;18923;47,28
3517703;Guará;2045;21777;406;22183;98,17
3517802;Guaraçai;2045;6886;907;7793;88,36
3517901;Guaraci;2045;11393;458;11851;96,14
3518008;Guarani d'Oeste;2045;1609;149;1758;91,52
3518107;Guarantã;2045;6301;221;6522;96,61
3518206;Guararapes;2045;30830;1208;32038;96,23
3518305;Guararema;2045;29931;4850;34781;86,06
3518404;Guaratinguetá;2045;113924;5209;119133;95,63
3518503;Guareí;2045;9688;7084;16772;57,76
3518602;Guariba;2045;42021;360;42381;99,15
3518701;Guarujá;2045;349941;67;350008;99,98
3518800;Guarulhos;2045;1522900;0;1522900;100
3518859;Guatapará;2045;7246;664;7910;91,61
3518909;Guzolândia;2045;5113;268;5381;95,02
3519006;Herculândia;2045;9550;470;10020;95,31
3519055;Holambra;2045;17567;686;18253;96,24
3519071;Hortolândia;2045;278568;0;278568;100
3519105;Iacanga;2045;11530;1043;12573;91,7
3519204;Iacri;2045;5216;452;5668;92,03
3519253;Iaras;2045;3463;4320;7783;44,49
3519303;Ibaté;2045;37838;1149;38987;97,05
3519402;Ibirá;2045;11906;772;12678;93,91
3519501;Ibirarema;2045;8043;402;8445;95,24
3519600;Ibitinga;2045;59539;1761;61300;97,13
3519709;Ibiúna;2045;34238;47730;81968;41,77
3519808;Icém;2045;7700;1002;8702;88,49
3519907;Iepê;2045;7850;256;8106;96,84
3520004;Igaraçu do Tietê;2045;24346;140;24486;99,43
3520103;Igarapava;2045;29331;881;30212;97,08
3520202;Igaratá;2045;9305;600;9905;93,94
3520301;Iguape;2045;27123;3456;30579;88,7
3520400;Ilhabela;2045;38765;269;39034;99,31
3520426;Ilha Comprida;2045;12185;0;12185;100
3520442;Ilha Solteira;2045;22501;1477;23978;93,84
3520509;Indaiatuba;2045;272842;2771;275613;98,99
3520608;Indiana;2045;4190;331;4521;92,68
3520707;Indiaporã;2045;3270;227;3497;93,51
3520806;Inúbia Paulista;2045;3857;201;4058;95,05
3520905;Ipaussu;2045;14764;721;15485;95,34
3521002;Iperó;2045;25020;15528;40548;61,7
3521101;Ipeúna;2045;9460;390;9850;96,04
3521150;Ipiguá;2045;4301;1523;5824;73,85
3521200;Iporanga;2045;4017;762;4779;84,06
3521309;Ipuã;2045;17429;383;17812;97,85
3521408;Iracemápolis;2045;26432;463;26895;98,28
3521507;Irapuã;2045;7434;491;7925;93,8
3521606;Irapuru;2045;4494;1862;6356;70,7
3521705;Itaberá;2045;15776;1902;17678;89,24
3521804;Itaí;2045;23242;6357;29599;78,52
3521903;Itajobi;2045;12330;998;13328;92,51
3522000;Itaju;2045;3728;299;4027;92,58
3522109;Itanhaém;2045;114289;502;114791;99,56
3522158;Itaóca;2045;1727;1440;3167;54,53
3522208;Itapecerica da Serra;2045;194715;1627;196342;99,17
3522307;Itapetininga;2045;169473;10001;179474;94,43
3522406;Itapeva;2045;95648;2524;98172;97,43
3522505;Itapevi;2045;304828;0;304828;100
3522604;Itapira;2045;64726;3035;67761;95,52
3522653;Itapirapuã Paulista;2045;2789;2042;4831;57,73
3522703;Itápolis;2045;39293;1413;40706;96,53
3522802;Itaporanga;2045;13323;1369;14692;90,68
3522901;Itapuí;2045;15332;291;15623;98,14
3523008;Itapura;2045;4505;1132;5637;79,92
3523107;Itaquaquecetuba;2045;448480;0;448480;100
3523206;Itararé;2045;47636;3249;50885;93,62
3523305;Itariri;2045;16661;3530;20191;82,52
3523404;Itatiba;2045;120566;10540;131106;91,96
3523503;Itatinga;2045;23619;788;24407;96,77
3523602;Itirapina;2045;18064;784;18848;95,84
3523701;Itirapuã;2045;6144;552;6696;91,76
3523800;Itobi;2045;7008;178;7186;97,52
3523909;Itu;2045;179351;5000;184351;97,29
3524006;Itupeva;2045;75982;1717;77699;97,79
3524105;Ituverava;2045;37334;2321;39655;94,15
3524204;Jaborandi;2045;6276;231;6507;96,45
3524303;Jaboticabal;2045;71313;412;71725;99,43
3524402;Jacareí;2045;237419;3325;240744;98,62
3524501;Jaci;2045;7442;492;7934;93,8
3524600;Jacupiranga;2045;9558;7997;17555;54,45
3524709;Jaguariúna;2045;62850;1100;63950;98,28
3524808;Jales;2045;40923;2565;43488;94,1
3524907;Jambeiro;2045;3376;3676;7052;47,87
3525003;Jandira;2045;146239;0;146239;100
3525102;Jardinópolis;2045;47677;230;47907;99,52
3525201;Jarinu;2045;36885;1664;38549;95,68
3525300;Jaú;2045;155866;2911;158777;98,17
3525409;Jeriquara;2045;2869;192;3061;93,73
3525508;Joanópolis;2045;12989;0;12989;100
3525607;João Ramalho;2045;4278;298;4576;93,49
3525706;José Bonifácio;2045;35894;2419;38313;93,69
3525805;Júlio Mesquita;2045;4622;217;4839;95,52
3525854;Jumirim;2045;3103;715;3818;81,27
3525904;Jundiaí;2045;421546;8137;429683;98,11
3526001;Junqueirópolis;2045;19130;2054;21184;90,3
3526100;Juquiá;2045;13478;5629;19107;70,54
3526209;Juquitiba;2045;32517;1446;33963;95,74
3526308;Lagoinha;2045;3880;798;4678;82,94
3526407;Laranjal Paulista;2045;28203;2228;30431;92,68
3526506;Lavínia;2045;3812;3998;7810;48,81
3526605;Lavrinhas;2045;7712;258;7970;96,76
3526704;Leme;2045;108955;1907;110862;98,28
3526803;Lençóis Paulista;2045;68007;1158;69165;98,33
3526902;Limeira;2045;297495;5517;303012;98,18
3527009;Lindóia;2045;8549;0;8549;100
3527108;Lins;2045;73519;870;74389;98,83
3527207;Lorena;2045;88598;1904;90502;97,9
3527256;Lourdes;2045;1869;163;2032;91,98
3527306;Louveira;2045;58633;1046;59679;98,25
3527405;Lucélia;2045;18853;2256;21109;89,31
3527504;Lucianópolis;2045;1922;303;2225;86,38
3527603;Luís Antônio;2045;17140;65;17205;99,62
3527702;Luiziânia;2045;6399;176;6575;97,32
3527801;Lupércio;2045;4228;199;4427;95,5
3527900;Lutécia;2045;2214;233;2447;90,48
3528007;Macatuba;2045;17033;300;17333;98,27
3528106;Macaubal;2045;6506;481;6987;93,12
3528205;Macedônia;2045;2686;429;3115;86,23
3528304;Magda;2045;2451;280;2731;89,75
3528403;Mairinque;2045;39804;9791;49595;80,26
3528502;Mairiporã;2045;117639;3162;120801;97,38
3528601;Manduri;2045;9530;226;9756;97,68
3528700;Marabá Paulista;2045;2225;2774;4999;44,51
3528809;Maracaí;2045;12314;703;13017;94,6
3528858;Marapoama;2045;2817;191;3008;93,65
3528908;Mariápolis;2045;3645;252;3897;93,53
3529005;Marília;2045;226035;10617;236652;95,51
3529104;Marinópolis;2045;1708;232;1940;88,04
3529203;Martinópolis;2045;24223;2106;26329;92
3529302;Matão;2045;76747;1435;78182;98,16
3529401;Mauá;2045;500227;0;500227;100
3529500;Mendonça;2045;4564;377;4941;92,37
3529609;Meridiano;2045;2575;688;3263;78,92
3529658;Mesópolis;2045;1715;129;1844;93
3529708;Miguelópolis;2045;21622;620;22242;97,21
3529807;Mineiros do Tietê;2045;12430;582;13012;95,53
3529906;Miracatu;2045;12598;8328;20926;60,2
3530003;Mira Estrela;2045;1906;951;2857;66,71
3530102;Mirandópolis;2045;27200;1445;28645;94,96
3530201;Mirante do Paranapanema;2045;10627;7421;18048;58,88
3530300;Mirassol;2045;57532;1491;59023;97,47
3530409;Mirassolândia;2045;4194;964;5158;81,31
3530508;Mococa;2045;61204;1493;62697;97,62
3530607;Mogi das Cruzes;2045;469235;29644;498879;94,06
3530706;Mogi-Guaçu;2045;149707;4104;153811;97,33
3530805;Moji Mirim;2045;87289;2005;89294;97,75
3530904;Mombuca;2045;3232;145;3377;95,71
3531001;Monções;2045;1807;213;2020;89,46
3531100;Mongaguá;2045;65039;285;65324;99,56
3531209;Monte Alegre do Sul;2045;5870;2105;7975;73,61
3531308;Monte Alto;2045;45605;603;46208;98,7
3531407;Monte Aprazível;2045;21894;1436;23330;93,84
3531506;Monte Azul Paulista;2045;15692;531;16223;96,73
3531605;Monte Castelo;2045;3267;319;3586;91,1
3531704;Monteiro Lobato;2045;2240;2470;4710;47,56
3531803;Monte Mor;2045;73576;1963;75539;97,4
3531902;Morro Agudo;2045;36392;659;37051;98,22
3532009;Morungaba;2045;14093;610;14703;95,85
3532058;Motuca;2045;4426;445;4871;90,86
3532108;Murutinga do Sul;2045;2409;1510;3919;61,47
3532157;Nantes;2045;3518;76;3594;97,89
3532207;Narandiba;2045;5214;390;5604;93,04
3532306;Natividade da Serra;2045;2957;3725;6682;44,25
3532405;Nazaré Paulista;2045;20471;360;20831;98,27
3532504;Neves Paulista;2045;7018;482;7500;93,57
3532603;Nhandeara;2045;8379;1040;9419;88,96
3532702;Nipoã;2045;5232;394;5626;93
3532801;Nova Aliança;2045;6141;513;6654;92,29
3532827;Nova Campina;2045;11068;700;11768;94,05
3532843;Nova Canaã Paulista;2045;1065;446;1511;70,48
3532868;Nova Castilho;2045;1115;63;1178;94,65
3532900;Nova Europa;2045;11843;396;12239;96,76
3533007;Nova Granada;2045;20981;1357;22338;93,93
3533106;Nova Guataporanga;2045;1919;112;2031;94,49
3533205;Nova Independência;2045;4051;309;4360;92,91
3533254;Novais;2045;6149;398;6547;93,92
3533304;Nova Lusitânia;2045;4484;132;4616;97,14
3533403;Nova Odessa;2045;61832;1024;62856;98,37
3533502;Novo Horizonte;2045;37154;2400;39554;93,93
3533601;Nuporanga;2045;7204;148;7352;97,99
3533700;Ocauçu;2045;3686;260;3946;93,41
3533809;Óleo;2045;1860;379;2239;83,07
3533908;Olímpia;2045;51204;1813;53017;96,58
3534005;Onda Verde;2045;4143;357;4500;92,07
3534104;Oriente;2045;5861;276;6137;95,5
3534203;Orindiúva;2045;7552;491;8043;93,9
3534302;Orlândia;2045;41970;1110;43080;97,42
3534401;Osasco;2045;709587;0;709587;100
3534500;Oscar Bressane;2045;2065;148;2213;93,31
3534609;Osvaldo Cruz;2045;27088;1766;28854;93,88
3534708;Ourinhos;2045;113532;3010;116542;97,42
3534757;Ouroeste;2045;10449;676;11125;93,92
3534807;Ouro Verde;2045;8457;284;8741;96,75
3534906;Pacaembu;2045;9037;3228;12265;73,68
3535002;Palestina;2045;11129;1184;12313;90,38
3535101;Palmares Paulista;2045;14951;443;15394;97,12
3535200;Palmeira d'Oeste;2045;7080;851;7931;89,27
3535309;Palmital;2045;19738;933;20671;95,49
3535408;Panorama;2045;15600;325;15925;97,96
3535507;Paraguaçu Paulista;2045;40403;4180;44583;90,62
3535606;Paraibuna;2045;5877;13618;19495;30,15
3535705;Paraíso;2045;5995;418;6413;93,48
3535804;Paranapanema;2045;21481;1503;22984;93,46
3535903;Paranapuã;2045;3458;235;3693;93,64
3536000;Parapuã;2045;8550;747;9297;91,97
3536109;Pardinho;2045;7628;208;7836;97,35
3536208;Pariquera-Açu;2045;15176;5018;20194;75,15
3536257;Parisi;2045;1698;219;1917;88,58
3536307;Patrocínio Paulista;2045;15415;1320;16735;92,11
3536406;Paulicéia;2045;7781;344;8125;95,77
3536505;Paulínia;2045;129308;120;129428;99,91
3536570;Paulistânia;2045;1551;137;1688;91,88
3536604;Paulo de Faria;2045;7746;555;8301;93,31
3536703;Pederneiras;2045;45495;3425;48920;93
3536802;Pedra Bela;2045;2325;3576;5901;39,4
3536901;Pedranópolis;2045;1427;672;2099;67,98
3537008;Pedregulho;2045;13017;3859;16876;77,13
3537107;Pedreira;2045;50201;425;50626;99,16
3537156;Pedrinhas Paulista;2045;2642;246;2888;91,48
3537206;Pedro de Toledo;2045;9150;3119;12269;74,58
3537305;Penápolis;2045;58465;1254;59719;97,9
3537404;Pereira Barreto;2045;23361;1289;24650;94,77
3537503;Pereiras;2045;6223;3095;9318;66,78
3537602;Peruíbe;2045;76657;134;76791;99,83
3537701;Piacatu;2045;6167;229;6396;96,42
3537800;Piedade;2045;27528;26345;53873;51,1
3537909;Pilar do Sul;2045;27418;2653;30071;91,18
3538006;Pindamonhangaba;2045;172688;3748;176436;97,88
3538105;Pindorama;2045;15520;877;16397;94,65
3538204;Pinhalzinho;2045;8444;7465;15909;53,08
3538303;Piquerobi;2045;2924;414;3338;87,6
3538501;Piquete;2045;11993;736;12729;94,22
3538600;Piracaia;2045;26719;0;26719;100
3538709;Piracicaba;2045;388963;6815;395778;98,28
3538808;Piraju;2045;25926;1180;27106;95,65
3538907;Pirajuí;2045;18900;3798;22698;83,27
3539004;Pirangi;2045;9654;505;10159;95,03
3539103;Pirapora do Bom Jesus;2045;24274;0;24274;100
3539202;Pirapozinho;2045;28877;845;29722;97,16
3539301;Pirassununga;2045;70315;2570;72885;96,47
3539400;Piratininga;2045;12785;1245;14030;91,13
3539509;Pitangueiras;2045;42297;410;42707;99,04
3539608;Planalto;2045;5598;429;6027;92,88
3539707;Platina;2045;3577;433;4010;89,2
3539806;Poá;2045;124822;2004;126826;98,42
3539905;Poloni;2045;4985;616;5601;89
3540002;Pompéia;2045;20908;1151;22059;94,78
3540101;Pongaí;2045;2763;174;2937;94,08
3540200;Pontal;2045;58824;229;59053;99,61
3540259;Pontalinda;2045;4487;368;4855;92,42
3540309;Pontes Gestal;2045;2298;172;2470;93,04
3540408;Populina;2045;3062;381;3443;88,93
3540507;Porangaba;2045;4820;5162;9982;48,29
3540606;Porto Feliz;2045;49015;4023;53038;92,41
3540705;Porto Ferreira;2045;54054;987;55041;98,21
3540754;Potim;2045;16766;5343;22109;75,83
3540804;Potirendaba;2045;15792;1071;16863;93,65
3540853;Pracinha;2045;1424;1549;2973;47,9
3540903;Pradópolis;2045;23522;1336;24858;94,63
3541000;Praia Grande;2045;378929;0;378929;100
3541059;Pratânia;2045;5507;546;6053;90,98
3541109;Presidente Alves;2045;3497;201;3698;94,56
3541208;Presidente Bernardes;2045;11644;912;12556;92,74
3541307;Presidente Epitácio;2045;40363;2010;42373;95,26
3541406;Presidente Prudente;2045;218488;4550;223038;97,96
3541505;Presidente Venceslau;2045;34932;763;35695;97,86
3541604;Promissão;2045;40022;4718;44740;89,45
3541653;Quadra;2045;1131;3103;4234;26,71
3541703;Quatá;2045;14478;685;15163;95,48
3541802;Queiroz;2045;3703;216;3919;94,49
3541901;Queluz;2045;11269;2471;13740;82,02
3542008;Quitana;2045;6558;422;6980;93,95
3542107;Rafard;2045;8882;605;9487;93,62
3542206;Rancharia;2045;26603;1361;27964;95,13
3542305;Redenção da Serra;2045;3389;285;3674;92,24
3542404;Regente Feijó;2045;18859;722;19581;96,31
3542503;Reginópolis;2045;4057;2754;6811;59,57
3542602;Registro;2045;49072;6206;55278;88,77
3542701;Restinga;2045;7927;945;8872;89,35
3542800;Ribeira;2045;2196;1041;3237;67,84
3542909;Ribeirão Bonito;2045;13705;475;14180;96,65
3543006;Ribeirão Branco;2045;13481;3957;17438;77,31
3543105;Ribeirão Corrente;2045;4665;581;5246;88,92
3543204;Ribeirão do Sul;2045;3629;329;3958;91,69
3543238;Ribeirão dos Índios;2045;1835;110;1945;94,34
3543253;Ribeirão Grande;2045;2472;5251;7723;32,01
3543303;Ribeirão Pires;2045;119663;0;119663;100
3543402;Ribeirão Preto;2045;730946;2080;733026;99,72
3543501;Riversul;2045;4405;1021;5426;81,18
3543600;Rifaina;2045;3025;289;3314;91,28
3543709;Rincão;2045;8909;1550;10459;85,18
3543808;Rinópolis;2045;8451;441;8892;95,04
3543907;Rio Claro;2045;204410;3909;208319;98,12
3544004;Rio das Pedras;2045;38542;682;39224;98,26
3544103;Rio Grande da Serra;2045;57213;0;57213;100
3544202;Riolândia;2045;9972;2633;12605;79,11
3544251;Rosana;2045;16729;349;17078;97,96
3544301;Roseira;2045;11462;319;11781;97,29
3544400;Rubiácea;2045;2395;1168;3563;67,22
3544509;Rubinéia;2045;2657;207;2864;92,77
3544608;Sabino;2045;5324;226;5550;95,93
3544707;Sagres;2045;2122;129;2251;94,27
3544806;Sales;2045;5896;382;6278;93,92
3544905;Sales Oliveira;2045;11663;301;11964;97,48
3545001;Salesópolis;2045;13605;5140;18745;72,58
3545100;Salmourão;2045;5123;134;5257;97,45
3545159;Saltinho;2045;6648;1177;7825;84,96
3545209;Salto;2045;121606;861;122467;99,3
3545308;Salto de Pirapora;2045;38114;9835;47949;79,49
3545407;Salto Grande;2045;9025;533;9558;94,42
3545506;Sandovalina;2045;4571;334;4905;93,19
3545605;Santa Adélia;2045;13989;797;14786;94,61
3545704;Santa Albertina;2045;4619;355;4974;92,86
3545803;Santa Bárbara d'Oeste;2045;186591;1476;188067;99,22
3546009;Santa Branca;2045;12498;1671;14169;88,21
3546108;Santa Clara d'Oeste;2045;1561;207;1768;88,29
3546207;Santa Cruz da Conceição;2045;4082;333;4415;92,46
3546256;Santa Cruz da Esperança;2045;1566;627;2193;71,41
3546306;Santa Cruz das Palmeiras;2045;37105;659;37764;98,25
3546405;Santa Cruz do Rio Pardo;2045;45483;2220;47703;95,35
3546504;Santa Ernestina;2045;5223;154;5377;97,14
3546603;Santa Fé do Sul;2045;28911;1185;30096;96,06
3546702;Santa Gertrudes;2045;32325;347;32672;98,94
3546801;Santa Isabel;2045;52060;7974;60034;86,72
3546900;Santa Lucia;2045;8738;268;9006;97,02
3547007;Santa Maria da Serra;2045;7059;367;7426;95,06
3547106;Santa Mercedes;2045;2691;101;2792;96,38
3547205;Santana da Ponte Pensa;2045;1023;172;1195;85,61
3547304;Santana de Parnaíba;2045;184496;0;184496;100
3547403;Santa Rita d'Oeste;2045;1754;194;1948;90,04
3547502;Santa Rita do Passa Quatro;2045;23548;1178;24726;95,24
3547601;Santa Rosa do Viterbo;2045;25779;593;26372;97,75
3547650;Santa Salete;2045;1142;132;1274;89,64
3547700;Santo Anastácio;2045;18440;755;19195;96,07
3547809;Santo André;2045;675412;0;675412;100
3547908;Santo Antonio da Alegria;2045;5180;1437;6617;78,28
3548005;Santo Antonio da Posse;2045;24660;487;25147;98,06
3548054;Santo Antonio do Aracanguá;2045;8181;356;8537;95,83
3548104;Santo Antonio do Jardim;2045;4308;1231;5539;77,78
3548203;Santo Antonio do Pinhal;2045;5931;860;6791;87,34
3548302;Santo Expedito;2045;3033;85;3118;97,27
3548401;Santópolis do Aguapeí;2045;4933;99;5032;98,03
3548500;Santos;2045;430898;323;431221;99,93
3548609;São Bento do Sapucaí;2045;6123;4063;10186;60,11
3548708;São Bernardo do Campo;2045;818232;12196;830428;98,53
3548807;São Caetano do Sul;2045;137776;0;137776;100
3548906;São Carlos;2045;241710;10084;251794;96
3549003;São Francisco;2045;2111;261;2372;89
3549102;São João da Boa Vista;2045;82338;1517;83855;98,19
3549201;São João das Duas Pontes;2045;1722;468;2190;78,63
3549250;São João de Iracema;2045;1730;63;1793;96,49
3549300;São João do Pau d'Alho;2045;1563;102;1665;93,87
3549409;São Joaquim da Barra;2045;51817;926;52743;98,24
3549508;São José da Bela Vista;2045;8769;486;9255;94,75
3549607;São José do Barreiro;2045;3726;342;4068;91,59
3549706;São José do Rio Pardo;2045;49884;1824;51708;96,47
3549805;São José do Rio Preto;2045;429837;27761;457598;93,93
3549904;São José dos Campos;2045;772357;16039;788396;97,97
3549953;São Lourenço da Serra;2045;17137;668;17805;96,25
3550001;São Luís do Paraitinga;2045;6473;4098;10571;61,23
3550100;São Manuel;2045;39692;411;40103;98,98
3550209;São Miguel Arcanjo;2045;30818;3309;34127;90,3
3550308;São Paulo;2045;12224824;110887;12335711;99,1
3550407;São Pedro;2045;33268;2808;36076;92,22
3550506;São Pedro do Turvo;2045;6562;893;7455;88,02
3550605;São Roque;2045;91919;1019;92938;98,9
3550704;São Sebastião;2045;103402;1178;104580;98,87
3550803;São Sebastião da Grama;2045;9269;2076;11345;81,7
3550902;São Simão;2045;14363;601;14964;95,98
3551009;São Vicente;2045;386619;732;387351;99,81
3551108;Sarapuí;2045;10628;1021;11649;91,24
3551207;Sarutaiá;2045;3463;236;3699;93,62
3551306;Sebastianópolis do Sul;2045;2960;240;3200;92,5
3551405;Serra Azul;2045;9820;3967;13787;71,23
3551504;Serrana;2045;50671;155;50826;99,7
3551603;Serra Negra;2045;23301;3214;26515;87,88
3551702;Sertãozinho;2045;129887;375;130262;99,71
3551801;Sete Barras;2045;11459;1698;13157;87,09
3551900;Severínia;2045;18346;578;18924;96,95
3552007;Silveiras;2045;4266;2429;6695;63,72
3552106;Socorro;2045;30435;7941;38376;79,31
3552205;Sorocaba;2045;706187;7261;713448;98,98
3552304;Sud Mennucci;2045;6736;1037;7773;86,66
3552403;Sumaré;2045;327742;3905;331647;98,82
3552502;Suzano;2045;320154;11681;331835;96,48
3552551;Suzanópolis;2045;3054;1521;4575;66,75
3552601;Tabapuã;2045;10934;706;11640;93,93
3552700;Tabatinga;2045;16207;772;16979;95,45
3552809;Taboão da Serra;2045;343208;0;343208;100
3552908;Taciba;2045;5868;454;6322;92,82
3553005;Taguaí;2045;11726;4643;16369;71,64
3553104;Taiaçu;2045;5711;236;5947;96,03
3553203;Taiúva;2045;5468;208;5676;96,34
3553302;Tambaú;2045;21768;1101;22869;95,19
3553401;Tanabi;2045;22559;1462;24021;93,91
3553500;Tapiraí;2045;6476;1352;7828;82,73
3553609;Tapiratiba;2045;11484;406;11890;96,59
3553658;Taquaral;2045;2640;52;2692;98,07
3553708;Taquaritinga;2045;50944;1544;52488;97,06
3553807;Taquarituba;2045;22604;977;23581;95,86
3553856;Taquarivaí;2045;4492;2275;6767;66,38
3553906;Tarabaí;2045;7774;301;8075;96,27
3553955;Tarumã;2045;16169;761;16930;95,51
3554003;Tatuí;2045;135360;1814;137174;98,68
3554102;Taubaté;2045;320143;6648;326791;97,97
3554201;Tejupá;2045;4491;359;4850;92,6
3554300;Teodoro Sampaio;2045;20066;3284;23350;85,94
3554409;Terra Roxa;2045;9400;304;9704;96,87
3554508;Tietê;2045;42311;3479;45790;92,4
3554607;Timburi;2045;2015;297;2312;87,15
3554656;Torre de Pedra;2045;1915;393;2308;82,97
3554706;Torrinha;2045;8674;804;9478;91,52
3554755;Trabiju;2045;1790;75;1865;95,98
3554805;Tremembé;2045;48833;1791;50624;96,46
3554904;Três Fronteiras;2045;4906;395;5301;92,55
3554953;Tuiuti;2045;4435;2450;6885;64,42
3555000;Tupã;2045;55160;2305;57465;95,99
3555109;Tupi Paulista;2045;10782;2946;13728;78,54
3555208;Turiúba;2045;1493;169;1662;89,83
3555307;Turmalina;2045;1194;215;1409;84,74
3555356;Ubarana;2045;6503;456;6959;93,45
3555406;Ubatuba;2045;98689;2229;100918;97,79
3555505;Ubirajara;2045;3705;1190;4895;75,69
3555604;Uchôa;2045;8583;554;9137;93,94
3555703;União Paulista;2045;1695;252;1947;87,06
3555802;Urânia;2045;6897;656;7553;91,31
3555901;Uru;2045;1073;22;1095;97,99
3556008;Urupês;2045;11841;796;12637;93,7
3556107;Valentim Gentil;2045;13258;872;14130;93,83
3556206;Valinhos;2045;130259;4701;134960;96,52
3556305;Valparaíso;2045;24845;494;25339;98,05
3556354;Vargem;2045;9360;1585;10945;85,52
3556404;Vargem Grande do Sul;2045;42240;1002;43242;97,68
3556453;Vargem Grande Paulista;2045;69724;0;69724;100
3556503;Várzea Paulista;2045;132926;0;132926;100
3556602;Vera Cruz;2045;9207;626;9833;93,63
3556701;Vinhedo;2045;85848;2785;88633;96,86
3556800;Viradouro;2045;18676;563;19239;97,07
3556909;Vista Alegre do Alto;2045;8638;300;8938;96,64
3556958;Vitória Brasil;2045;1536;110;1646;93,32
3557006;Votorantim;2045;125542;4978;130520;96,19
3557105;Votuporanga;2045;88474;2550;91024;97,2
3557154;Zacarias;2045;2459;211;2670;92,1
3557204;Chavantes;2045;11627;556;12183;95,44
3557303;Estiva Gerbi;2045;9374;2379;11753;79,76
3500105;Adamantina;2050;30015;671;30686;97,81
3500204;Adolfo;2050;2725;178;2903;93,87
3500303;Aguaí;2050;38020;1682;39702;95,76
3500402;Águas da Prata;2050;6908;252;7160;96,48
3500501;Águas de Lindóia;2050;18311;166;18477;99,1
3500550;Águas de Santa Bárbara;2050;5037;1082;6119;82,32
3500600;Águas de São Pedro;2050;3272;0;3272;100
3500709;Agudos;2050;35429;868;36297;97,61
3500758;Alambari;2050;6461;463;6924;93,31
3500808;Alfredo Marcondes;2050;3368;102;3470;97,06
3500907;Altair;2050;3808;281;4089;93,13
3501004;Altinópolis;2050;14057;322;14379;97,76
3501103;Alto Alegre;2050;3283;196;3479;94,37
3501152;Alumínio;2050;16273;3130;19403;83,87
3501202;Álvares Florence;2050;2276;403;2679;84,96
3501301;Álvares Machado;2050;21419;1374;22793;93,97
3501400;Álvaro de Carvalho;2050;4430;1300;5730;77,31
3501509;Alvinlândia;2050;3226;173;3399;94,91
3501608;Americana;2050;238778;1121;239899;99,53
3501707;Américo Brasiliense;2050;46591;355;46946;99,24
3501806;Américo de Campos;2050;4652;380;5032;92,45
3501905;Amparo;2050;62181;4328;66509;93,49
3502002;Analândia;2050;5075;428;5503;92,22
3502101;Andradina;2050;50596;2014;52610;96,17
3502200;Angatuba;2050;22347;4771;27118;82,41
3502309;Anhembi;2050;6998;1099;8097;86,43
3502408;Anhumas;2050;3869;176;4045;95,65
3502507;Aparecida;2050;33442;493;33935;98,55
3502606;Aparecida d'Oeste;2050;2981;237;3218;92,64
3502705;Apiaí;2050;24130;1409;25539;94,48
3502754;Araçariguama;2050;26690;0;26690;100
3502804;Araçatuba;2050;176762;3476;180238;98,07
3502903;Araçoiaba da Serra;2050;27589;12549;40138;68,74
3503000;Aramina;2050;5360;103;5463;98,11
3503109;Arandu;2050;5629;351;5980;94,13
3503158;Arapeí;2050;1906;366;2272;83,89
3503208;Araraquara;2050;221508;6481;227989;97,16
3503307;Araras;2050;131376;4805;136181;96,47
3503356;Arco-Íris;2050;1181;284;1465;80,61
3503406;Arealva;2050;7454;563;8017;92,98
3503505;Areias;2050;2792;1373;4165;67,03
3503604;Areiópolis;2050;11105;277;11382;97,57
3503703;Ariranha;2050;9207;515;9722;94,7
3503802;Artur Nogueira;2050;55517;5800;61317;90,54
3503901;Arujá;2050;109985;3357;113342;97,04
3503950;Aspásia;2050;1294;215;1509;85,75
3504008;Assis;2050;98122;4478;102600;95,64
3504107;Atibaia;2050;146744;4305;151049;97,15
3504206;Auriflama;2050;12717;436;13153;96,69
3504305;Avaí;2050;3651;1786;5437;67,15
3504404;Avanhandava;2050;11228;2051;13279;84,55
3504503;Avaré;2050;86046;1791;87837;97,96
3504602;Bady Bassitt;2050;15610;1008;16618;93,93
3504701;Balbinos;2050;1163;2452;3615;32,17
3504800;Bálsamo;2050;7493;485;7978;93,92
3504909;Bananal;2050;10332;802;11134;92,8
3505005;Barão de Antonina;2050;2619;1103;3722;70,37
3505104;Barbosa;2050;7379;996;8375;88,11
3505203;Bariri;2050;34165;702;34867;97,99
3505302;Barra Bonita;2050;30103;516;30619;98,31
3505351;Barra do Chapéu;2050;1828;4379;6207;29,45
3505401;Barra do Turvo;2050;5196;3109;8305;62,56
3505500;Barretos;2050;110770;3480;114250;96,95
3505609;Barrinha;2050;37342;419;37761;98,89
3505708;Barueri;2050;299366;0;299366;100
3505807;Bastos;2050;17595;1331;18926;92,97
3505906;Batatais;2050;53382;6980;60362;88,44
3506003;Bauru;2050;351508;5980;357488;98,33
3506102;Bebedouro;2050;61467;1987;63454;96,87
3506201;Bento de Abreu;2050;3157;66;3223;97,95
3506300;Bernardino de Campos;2050;9591;583;10174;94,27
3506359;Bertioga;2050;89919;199;90118;99,78
3506409;Bilac;2050;7570;214;7784;97,25
3506508;Birigui;2050;123043;2701;125744;97,85
3506607;Biritiba Mirim;2050;35218;3610;38828;90,7
3506706;Boa Esperança do Sul;2050;14820;670;15490;95,67
3506805;Bocaina;2050;12962;543;13505;95,98
3506904;Bofete;2050;8260;4696;12956;63,75
3507001;Boituva;2050;64431;4063;68494;94,07
3507100;Bom Jesus dos Perdões;2050;28319;1252;29571;95,77
3507159;Bom Sucesso de Itararé;2050;4108;533;4641;88,52
3507209;Borá;2050;562;160;722;77,84
3507308;Boracéia;2050;4995;292;5287;94,48
3507407;Borborema;2050;14368;460;14828;96,9
3507456;Borebi;2050;2852;63;2915;97,84
3507506;Botucatu;2050;145659;3972;149631;97,35
3507605;Bragança Paulista;2050;174228;3049;177277;98,28
3507704;Braúna;2050;5928;153;6081;97,48
3507753;Brejo Alegre;2050;2605;194;2799;93,07
3507803;Brodowski;2050;25787;95;25882;99,63
3507902;Brotas;2050;23334;2897;26231;88,96
3508009;Buri;2050;21056;2303;23359;90,14
3508108;Buritama;2050;16108;375;16483;97,72
3508207;Buritizal;2050;3881;471;4352;89,18
3508306;Cabrália Paulista;2050;3652;439;4091;89,27
3508405;Cabreúva;2050;59788;2366;62154;96,19
3508504;Caçapava;2050;80107;13516;93623;85,56
3508603;Cachoeira Paulista;2050;28832;3949;32781;87,95
3508702;Caconde;2050;14818;3502;18320;80,88
3508801;Cafelândia;2050;16450;799;17249;95,37
3508900;Caiabu;2050;3658;281;3939;92,87
3509007;Caieiras;2050;116443;1204;117647;98,98
3509106;Caiuá;2050;2270;3657;5927;38,3
3509205;Cajamar;2050;102985;938;103923;99,1
3509254;Cajati;2050;24996;7405;32401;77,15
3509304;Cajobi;2050;9312;331;9643;96,57
3509403;Cajuru;2050;25492;2676;28168;90,5
3509452;Campina do Monte Alegre;2050;5630;329;5959;94,48
3509502;Campinas;2050;1180289;20651;1200940;98,28
3509601;Campo Limpo Paulista;2050;89373;0;89373;100
3509700;Campos do Jordão;2050;51374;322;51696;99,38
3509809;Campos Novos Paulista;2050;4706;462;5168;91,06
3509908;Cananéia;2050;11731;1540;13271;88,4
3509957;Canas;2050;5871;126;5997;97,9
3510005;Cândido Mota;2050;25639;1208;26847;95,5
3510104;Cândido Rodrigues;2050;2196;157;2353;93,33
3510153;Canitar;2050;5823;274;6097;95,51
3510203;Capão Bonito;2050;42197;3872;46069;91,6
3510302;Capela do Alto;2050;24524;1582;26106;93,94
3510401;Capivari;2050;59337;1041;60378;98,28
3510500;Caraguatatuba;2050;129592;3863;133455;97,11
3510609;Carapicuíba;2050;425783;0;425783;100
3510708;Cardoso;2050;9916;698;10614;93,42
3510807;Casa Branca;2050;25237;4237;29474;85,62
3510906;Cássia dos Coqueiros;2050;2018;167;2185;92,36
3511003;Castilho;2050;17845;5802;23647;75,46
3511102;Catanduva;2050;107963;874;108837;99,2
3511201;Catiguá;2050;6897;452;7349;93,85
3511300;Cedral;2050;8230;949;9179;89,66
3511409;Cerqueira César;2050;20621;745;21366;96,51
3511508;Cerquilho;2050;51595;2816;54411;94,82
3511607;Cesário Lange;2050;12542;6035;18577;67,51
3511706;Charqueada;2050;17716;1261;18977;93,36
3511904;Clementina;2050;9680;199;9879;97,99
3512001;Colina;2050;15698;518;16216;96,81
3512100;Colômbia;2050;4812;1042;5854;82,2
3512209;Conchal;2050;29010;541;29551;98,17
3512308;Conchas;2050;16628;1167;17795;93,44
3512407;Cordeirópolis;2050;25650;2907;28557;89,82
3512506;Coroados;2050;5811;384;6195;93,8
3512605;Coronel Macedo;2050;4141;395;4536;91,29
3512704;Corumbataí;2050;3210;698;3908;82,14
3512803;Cosmópolis;2050;79861;6129;85990;92,87
3512902;Cosmorama;2050;5296;628;5924;89,4
3513009;Cotia;2050;331909;0;331909;100
3513108;Cravinhos;2050;35780;169;35949;99,53
3513207;Cristais Paulista;2050;8700;398;9098;95,63
3513306;Cruzália;2050;1428;306;1734;82,35
3513405;Cruzeiro;2050;77734;1633;79367;97,94
3513504;Cubatão;2050;140211;0;140211;100
3513603;Cunha;2050;16248;4064;20312;79,99
3513702;Descalvado;2050;30048;1114;31162;96,43
3513801;Diadema;2050;415777;0;415777;100
3513850;Dirce Reis;2050;1403;130;1533;91,52
3513900;Divinolândia;2050;8862;924;9786;90,56
3514007;Dobrada;2050;9952;227;10179;97,77
3514106;Dois Córregos;2050;29329;530;29859;98,22
3514205;Dolcinópolis;2050;1624;105;1729;93,93
3514304;Dourado;2050;6877;556;7433;92,52
3514403;Dracena;2050;40204;2449;42653;94,26
3514502;Duartina;2050;10115;399;10514;96,21
3514601;Dumont;2050;10358;47;10405;99,55
3514700;Echaporã;2050;5095;621;5716;89,14
3514809;Eldorado;2050;8459;8730;17189;49,21
3514908;Elias Fausto;2050;17213;1361;18574;92,67
3514924;Elisiário;2050;3302;214;3516;93,91
3514957;Embaúba;2050;2036;119;2155;94,48
3515004;Embu;2050;316358;0;316358;100
3515103;Embu-Guaçu;2050;74947;2054;77001;97,33
3515129;Emilianópolis;2050;2666;135;2801;95,18
3515152;Engenheiro Coelho;2050;22183;4344;26527;83,62
3515186;Espírito Santo do Pinhal;2050;37747;1821;39568;95,4
3515194;Espírito Santo do Turvo;2050;4905;830;5735;85,53
3515202;Estrela d'Oeste;2050;6651;547;7198;92,4
3515301;Estrela do Norte;2050;2521;108;2629;95,89
3515350;Euclides da Cunha Paulista;2050;6473;3211;9684;66,84
3515400;Fartura;2050;14128;1423;15551;90,85
3515509;Fernandópolis;2050;58104;1836;59940;96,94
3515608;Fernando Prestes;2050;4738;186;4924;96,22
3515657;Fernão;2050;1345;385;1730;77,75
3515707;Ferraz de Vasconcelos;2050;219494;10312;229806;95,51
3515806;Flora Rica;2050;1202;55;1257;95,62
3515905;Floreal;2050;2026;208;2234;90,69
3516002;Flórida Paulista;2050;8095;2165;10260;78,9
3516101;Florínia;2050;2269;126;2395;94,74
3516200;Franca;2050;345003;6165;351168;98,24
3516309;Francisco Morato;2050;216851;442;217293;99,8
3516408;Franco da Rocha;2050;172252;14719;186971;92,13
3516507;Gabriel Monteiro;2050;2152;88;2240;96,07
3516606;Gália;2050;4705;859;5564;84,56
3516705;Garça;2050;35764;1720;37484;95,41
3516804;Gastão Vidigal;2050;5395;134;5529;97,58
3516853;Gavião Peixoto;2050;4483;165;4648;96,45
3516903;General Salgado;2050;8766;521;9287;94,39
3517000;Getulina;2050;9479;1050;10529;90,03
3517109;Glicério;2050;4052;708;4760;85,13
3517208;Guaiçara;2050;12871;440;13311;96,69
3517307;Guaimbê;2050;5459;200;5659;96,47
3517406;Guaíra;2050;36173;1137;37310;96,95
3517505;Guapiaçu;2050;21540;1518;23058;93,42
3517604;Guapiara;2050;9147;9786;18933;48,31
3517703;Guará;2050;21688;399;22087;98,19
3517802;Guaraçai;2050;6746;807;7553;89,32
3517901;Guaraci;2050;11335;428;11763;96,36
3518008;Guarani d'Oeste;2050;1555;139;1694;91,79
3518107;Guarantã;2050;6243;189;6432;97,06
3518206;Guararapes;2050;30313;1099;31412;96,5
3518305;Guararema;2050;30358;4920;35278;86,05
3518404;Guaratinguetá;2050;111804;5053;116857;95,68
3518503;Guareí;2050;9605;7023;16628;57,76
3518602;Guariba;2050;41747;321;42068;99,24
3518701;Guarujá;2050;349002;67;349069;99,98
3518800;Guarulhos;2050;1527615;0;1527615;100
3518859;Guatapará;2050;7308;553;7861;92,97
3518909;Guzolândia;2050;5094;233;5327;95,63
3519006;Herculândia;2050;9519;461;9980;95,38
3519055;Holambra;2050;18024;575;18599;96,91
3519071;Hortolândia;2050;280017;0;280017;100
3519105;Iacanga;2050;11564;979;12543;92,19
3519204;Iacri;2050;5063;395;5458;92,76
3519253;Iaras;2050;3495;4359;7854;44,5
3519303;Ibaté;2050;37726;1133;38859;97,08
3519402;Ibirá;2050;11771;762;12533;93,92
3519501;Ibirarema;2050;8067;396;8463;95,32
3519600;Ibitinga;2050;58601;1726;60327;97,14
3519709;Ibiúna;2050;34828;46607;81435;42,77
3519808;Icém;2050;7727;975;8702;88,8
3519907;Iepê;2050;7778;229;8007;97,14
3520004;Igaraçu do Tietê;2050;23859;138;23997;99,42
3520103;Igarapava;2050;28933;811;29744;97,27
3520202;Igaratá;2050;9349;515;9864;94,78
3520301;Iguape;2050;26923;3420;30343;88,73
3520400;Ilhabela;2050;38908;270;39178;99,31
3520426;Ilha Comprida;2050;12332;0;12332;100
3520442;Ilha Solteira;2050;21670;1423;23093;93,84
3520509;Indaiatuba;2050;272210;2764;274974;98,99
3520608;Indiana;2050;4106;295;4401;93,3
3520707;Indiaporã;2050;3165;215;3380;93,64
3520806;Inúbia Paulista;2050;3824;178;4002;95,55
3520905;Ipaussu;2050;14690;708;15398;95,4
3521002;Iperó;2050;25091;15571;40662;61,71
3521101;Ipeúna;2050;9669;346;10015;96,55
3521150;Ipiguá;2050;4373;1426;5799;75,41
3521200;Iporanga;2050;4155;648;4803;86,51
3521309;Ipuã;2050;17431;367;17798;97,94
3521408;Iracemápolis;2050;26263;460;26723;98,28
3521507;Irapuã;2050;7313;479;7792;93,85
3521606;Irapuru;2050;4310;1786;6096;70,7
3521705;Itaberá;2050;15902;1593;17495;90,89
3521804;Itaí;2050;23277;6366;29643;78,52
3521903;Itajobi;2050;11893;913;12806;92,87
3522000;Itaju;2050;3757;249;4006;93,78
3522109;Itanhaém;2050;115886;460;116346;99,6
3522158;Itaóca;2050;1708;1424;3132;54,53
3522208;Itapecerica da Serra;2050;196300;1641;197941;99,17
3522307;Itapetininga;2050;170267;9335;179602;94,8
3522406;Itapeva;2050;95535;2076;97611;97,87
3522505;Itapevi;2050;312823;0;312823;100
3522604;Itapira;2050;62602;2755;65357;95,78
3522653;Itapirapuã Paulista;2050;2888;2008;4896;58,99
3522703;Itápolis;2050;38217;1300;39517;96,71
3522802;Itaporanga;2050;13337;1175;14512;91,9
3522901;Itapuí;2050;15335;281;15616;98,2
3523008;Itapura;2050;4513;1134;5647;79,92
3523107;Itaquaquecetuba;2050;454319;0;454319;100
3523206;Itararé;2050;47354;3144;50498;93,77
3523305;Itariri;2050;17053;3309;20362;83,75
3523404;Itatiba;2050;120594;9556;130150;92,66
3523503;Itatinga;2050;24068;706;24774;97,15
3523602;Itirapina;2050;18142;710;18852;96,23
3523701;Itirapuã;2050;6153;498;6651;92,51
3523800;Itobi;2050;6803;157;6960;97,74
3523909;Itu;2050;178797;4490;183287;97,55
3524006;Itupeva;2050;77560;1605;79165;97,97
3524105;Ituverava;2050;36452;2266;38718;94,15
3524204;Jaborandi;2050;6144;219;6363;96,56
3524303;Jaboticabal;2050;69263;344;69607;99,51
3524402;Jacareí;2050;234890;3289;238179;98,62
3524501;Jaci;2050;7395;484;7879;93,86
3524600;Jacupiranga;2050;9446;7903;17349;54,45
3524709;Jaguariúna;2050;62990;1102;64092;98,28
3524808;Jales;2050;39317;2464;41781;94,1
3524907;Jambeiro;2050;3383;3682;7065;47,88
3525003;Jandira;2050;147310;0;147310;100
3525102;Jardinópolis;2050;47637;197;47834;99,59
3525201;Jarinu;2050;37929;1418;39347;96,4
3525300;Jaú;2050;154419;2814;157233;98,21
3525409;Jeriquara;2050;2825;164;2989;94,51
3525508;Joanópolis;2050;12766;0;12766;100
3525607;João Ramalho;2050;4242;274;4516;93,93
3525706;José Bonifácio;2050;35389;2354;37743;93,76
3525805;Júlio Mesquita;2050;4582;215;4797;95,52
3525854;Jumirim;2050;3194;627;3821;83,59
3525904;Jundiaí;2050;416352;7794;424146;98,16
3526001;Junqueirópolis;2050;19142;1873;21015;91,09
3526100;Juquiá;2050;13518;5399;18917;71,46
3526209;Juquitiba;2050;33055;1169;34224;96,58
3526308;Lagoinha;2050;3876;698;4574;84,74
3526407;Laranjal Paulista;2050;28239;2113;30352;93,04
3526506;Lavínia;2050;3670;3850;7520;48,8
3526605;Lavrinhas;2050;7739;238;7977;97,02
3526704;Leme;2050;108558;1900;110458;98,28
3526803;Lençóis Paulista;2050;66835;1137;67972;98,33
3526902;Limeira;2050;291372;5311;296683;98,21
3527009;Lindóia;2050;8491;0;8491;100
3527108;Lins;2050;71769;849;72618;98,83
3527207;Lorena;2050;87972;1871;89843;97,92
3527256;Lourdes;2050;1813;141;1954;92,78
3527306;Louveira;2050;59358;1050;60408;98,26
3527405;Lucélia;2050;18530;2139;20669;89,65
3527504;Lucianópolis;2050;1917;282;2199;87,18
3527603;Luís Antônio;2050;17288;59;17347;99,66
3527702;Luiziânia;2050;6437;163;6600;97,53
3527801;Lupércio;2050;4169;196;4365;95,51
3527900;Lutécia;2050;2173;207;2380;91,3
3528007;Macatuba;2050;16790;292;17082;98,29
3528106;Macaubal;2050;6246;447;6693;93,32
3528205;Macedônia;2050;2592;381;2973;87,18
3528304;Magda;2050;2374;255;2629;90,3
3528403;Mairinque;2050;39587;9738;49325;80,26
3528502;Mairiporã;2050;119780;2683;122463;97,81
3528601;Manduri;2050;9420;187;9607;98,05
3528700;Marabá Paulista;2050;2200;2742;4942;44,52
3528809;Maracaí;2050;12033;661;12694;94,79
3528858;Marapoama;2050;2767;184;2951;93,76
3528908;Mariápolis;2050;3612;215;3827;94,38
3529005;Marília;2050;221785;10417;232202;95,51
3529104;Marinópolis;2050;1658;209;1867;88,81
3529203;Martinópolis;2050;24014;1888;25902;92,71
3529302;Matão;2050;74619;1395;76014;98,16
3529401;Mauá;2050;496055;0;496055;100
3529500;Mendonça;2050;4426;344;4770;92,79
3529609;Meridiano;2050;2482;620;3102;80,01
3529658;Mesópolis;2050;1691;121;1812;93,32
3529708;Miguelópolis;2050;21423;572;21995;97,4
3529807;Mineiros do Tietê;2050;12288;575;12863;95,53
3529906;Miracatu;2050;12832;8078;20910;61,37
3530003;Mira Estrela;2050;1857;927;2784;66,7
3530102;Mirandópolis;2050;26898;1294;28192;95,41
3530201;Mirante do Paranapanema;2050;10424;7278;17702;58,89
3530300;Mirassol;2050;56279;1459;57738;97,47
3530409;Mirassolândia;2050;4186;963;5149;81,3
3530508;Mococa;2050;59424;1336;60760;97,8
3530607;Mogi das Cruzes;2050;472905;28655;501560;94,29
3530706;Mogi-Guaçu;2050;147512;3799;151311;97,49
3530805;Moji Mirim;2050;85284;1831;87115;97,9
3530904;Mombuca;2050;3198;122;3320;96,33
3531001;Monções;2050;1758;200;1958;89,79
3531100;Mongaguá;2050;66324;291;66615;99,56
3531209;Monte Alegre do Sul;2050;5902;1908;7810;75,57
3531308;Monte Alto;2050;44239;499;44738;98,88
3531407;Monte Aprazível;2050;21308;1389;22697;93,88
3531506;Monte Azul Paulista;2050;15057;497;15554;96,8
3531605;Monte Castelo;2050;3170;273;3443;92,07
3531704;Monteiro Lobato;2050;2245;2413;4658;48,2
3531803;Monte Mor;2050;74915;1856;76771;97,58
3531902;Morro Agudo;2050;36609;659;37268;98,23
3532009;Morungaba;2050;14111;529;14640;96,39
3532058;Motuca;2050;4415;380;4795;92,08
3532108;Murutinga do Sul;2050;2306;1445;3751;61,48
3532157;Nantes;2050;3540;75;3615;97,93
3532207;Narandiba;2050;5308;329;5637;94,16
3532306;Natividade da Serra;2050;2949;3660;6609;44,62
3532405;Nazaré Paulista;2050;20502;359;20861;98,28
3532504;Neves Paulista;2050;6681;451;7132;93,68
3532603;Nhandeara;2050;8024;929;8953;89,62
3532702;Nipoã;2050;5243;383;5626;93,19
3532801;Nova Aliança;2050;6065;478;6543;92,69
3532827;Nova Campina;2050;11411;560;11971;95,32
3532843;Nova Canaã Paulista;2050;1043;373;1416;73,66
3532868;Nova Castilho;2050;1108;50;1158;95,68
3532900;Nova Europa;2050;11841;381;12222;96,88
3533007;Nova Granada;2050;20757;1341;22098;93,93
3533106;Nova Guataporanga;2050;1877;98;1975;95,04
3533205;Nova Independência;2050;4100;271;4371;93,8
3533254;Novais;2050;6198;401;6599;93,92
3533304;Nova Lusitânia;2050;4500;120;4620;97,4
3533403;Nova Odessa;2050;61087;1012;62099;98,37
3533502;Novo Horizonte;2050;36442;2354;38796;93,93
3533601;Nuporanga;2050;7056;138;7194;98,08
3533700;Ocauçu;2050;3612;232;3844;93,96
3533809;Óleo;2050;1836;332;2168;84,69
3533908;Olímpia;2050;50374;1735;52109;96,67
3534005;Onda Verde;2050;4115;330;4445;92,58
3534104;Oriente;2050;5726;269;5995;95,51
3534203;Orindiúva;2050;7540;489;8029;93,91
3534302;Orlândia;2050;41178;1089;42267;97,42
3534401;Osasco;2050;703949;0;703949;100
3534500;Oscar Bressane;2050;1989;131;2120;93,82
3534609;Osvaldo Cruz;2050;26249;1596;27845;94,27
3534708;Ourinhos;2050;112487;2982;115469;97,42
3534757;Ouroeste;2050;10489;678;11167;93,93
3534807;Ouro Verde;2050;8414;260;8674;97
3534906;Pacaembu;2050;8789;3140;11929;73,68
3535002;Palestina;2050;10943;1093;12036;90,92
3535101;Palmares Paulista;2050;14982;444;15426;97,12
3535200;Palmeira d'Oeste;2050;6837;747;7584;90,15
3535309;Palmital;2050;19271;908;20179;95,5
3535408;Panorama;2050;15478;322;15800;97,96
3535507;Paraguaçu Paulista;2050;39701;4107;43808;90,63
3535606;Paraibuna;2050;5875;13612;19487;30,15
3535705;Paraíso;2050;5896;402;6298;93,62
3535804;Paranapanema;2050;21798;1304;23102;94,36
3535903;Paranapuã;2050;3353;224;3577;93,74
3536000;Parapuã;2050;8240;657;8897;92,62
3536109;Pardinho;2050;7842;171;8013;97,87
3536208;Pariquera-Açu;2050;15216;4825;20041;75,92
3536257;Parisi;2050;1653;199;1852;89,25
3536307;Patrocínio Paulista;2050;15717;1180;16897;93,02
3536406;Paulicéia;2050;7845;301;8146;96,3
3536505;Paulínia;2050;130315;121;130436;99,91
3536570;Paulistânia;2050;1532;110;1642;93,3
3536604;Paulo de Faria;2050;7592;531;8123;93,46
3536703;Pederneiras;2050;45082;3394;48476;93
3536802;Pedra Bela;2050;2424;3387;5811;41,71
3536901;Pedranópolis;2050;1380;627;2007;68,76
3537008;Pedregulho;2050;13004;3758;16762;77,58
3537107;Pedreira;2050;49698;421;50119;99,16
3537156;Pedrinhas Paulista;2050;2573;223;2796;92,02
3537206;Pedro de Toledo;2050;9278;3048;12326;75,27
3537305;Penápolis;2050;57219;1195;58414;97,95
3537404;Pereira Barreto;2050;22795;1209;24004;94,96
3537503;Pereiras;2050;6203;3086;9289;66,78
3537602;Peruíbe;2050;78071;114;78185;99,85
3537701;Piacatu;2050;6149;203;6352;96,8
3537800;Piedade;2050;27463;25465;52928;51,89
3537909;Pilar Do Sul;2050;27602;2320;29922;92,25
3538006;Pindamonhangaba;2050;171395;3666;175061;97,91
3538105;Pindorama;2050;15197;858;16055;94,66
3538204;Pinhalzinho;2050;8471;7326;15797;53,62
3538303;Piquerobi;2050;2874;364;3238;88,76
3538501;Piquete;2050;11679;707;12386;94,29
3538600;Piracaia;2050;26258;0;26258;100
3538709;Piracicaba;2050;381044;6671;387715;98,28
3538808;Piraju;2050;25397;1030;26427;96,1
3538907;Pirajuí;2050;18653;3684;22337;83,51
3539004;Pirangi;2050;9361;454;9815;95,37
3539103;Pirapora do Bom Jesus;2050;24790;0;24790;100
3539202;Pirapozinho;2050;28671;798;29469;97,29
3539301;Pirassununga;2050;68810;2284;71094;96,79
3539400;Piratininga;2050;12722;1152;13874;91,7
3539509;Pitangueiras;2050;42253;348;42601;99,18
3539608;Planalto;2050;5659;414;6073;93,18
3539707;Platina;2050;3654;403;4057;90,07
3539806;Poá;2050;124627;2001;126628;98,42
3539905;Poloni;2050;4876;602;5478;89,01
3540002;Pompéia;2050;20603;1107;21710;94,9
3540101;Pongaí;2050;2668;147;2815;94,78
3540200;Pontal;2050;59277;210;59487;99,65
3540259;Pontalinda;2050;4484;348;4832;92,8
3540309;Pontes Gestal;2050;2262;162;2424;93,32
3540408;Populina;2050;2943;341;3284;89,62
3540507;Porangaba;2050;4781;5122;9903;48,28
3540606;Porto Feliz;2050;48563;3558;52121;93,17
3540705;Porto Ferreira;2050;53128;970;54098;98,21
3540754;Potim;2050;16598;5290;21888;75,83
3540804;Potirendaba;2050;15486;1034;16520;93,74
3540853;Pracinha;2050;1416;1541;2957;47,89
3540903;Pradópolis;2050;23771;1288;25059;94,86
3541000;Praia Grande;2050;382757;0;382757;100
3541059;Pratânia;2050;5635;477;6112;92,2
3541109;Presidente Alves;2050;3410;169;3579;95,28
3541208;Presidente Bernardes;2050;11290;755;12045;93,73
3541307;Presidente Epitácio;2050;39711;1887;41598;95,46
3541406;Presidente Prudente;2050;213619;4448;218067;97,96
3541505;Presidente Venceslau;2050;33806;726;34532;97,9
3541604;Promissão;2050;40366;4469;44835;90,03
3541653;Quadra;2050;1138;3099;4237;26,86
3541703;Quatá;2050;14396;679;15075;95,5
3541802;Queiroz;2050;3737;206;3943;94,78
3541901;Queluz;2050;11158;2447;13605;82,01
3542008;Quitana;2050;6534;406;6940;94,15
3542107;Rafard;2050;8865;553;9418;94,13
3542206;Rancharia;2050;26079;1216;27295;95,54
3542305;Redenção da Serra;2050;3374;221;3595;93,85
3542404;Regente Feijó;2050;18497;653;19150;96,59
3542503;Reginópolis;2050;3953;2684;6637;59,56
3542602;Registro;2050;48516;6136;54652;88,77
3542701;Restinga;2050;8101;864;8965;90,36
3542800;Ribeira;2050;2305;911;3216;71,67
3542909;Ribeirão Bonito;2050;13727;455;14182;96,79
3543006;Ribeirão Branco;2050;13710;3404;17114;80,11
3543105;Ribeirão Corrente;2050;4735;534;5269;89,87
3543204;Ribeirão do Sul;2050;3523;282;3805;92,59
3543238;Ribeirão dos Índios;2050;1779;94;1873;94,98
3543253;Ribeirão Grande;2050;2455;5202;7657;32,06
3543303;Ribeirão Pires;2050;117245;0;117245;100
3543402;Ribeirão Preto;2050;721931;2055;723986;99,72
3543501;Riversul;2050;4390;951;5341;82,19
3543600;Rifaina;2050;2951;267;3218;91,7
3543709;Rincão;2050;8795;1471;10266;85,67
3543808;Rinópolis;2050;8187;412;8599;95,21
3543907;Rio Claro;2050;200870;3777;204647;98,15
3544004;Rio das Pedras;2050;38359;675;39034;98,27
3544103;Rio Grande da Serra;2050;57212;0;57212;100
3544202;Riolândia;2050;9990;2638;12628;79,11
3544251;Rosana;2050;16238;338;16576;97,96
3544301;Roseira;2050;11456;304;11760;97,41
3544400;Rubiácea;2050;2432;1118;3550;68,51
3544509;Rubinéia;2050;2596;193;2789;93,08
3544608;Sabino;2050;5292;198;5490;96,39
3544707;Sagres;2050;2097;106;2203;95,19
3544806;Sales;2050;5824;377;6201;93,92
3544905;Sales Oliveira;2050;11488;270;11758;97,7
3545001;Salesópolis;2050;13927;4962;18889;73,73
3545100;Salmourão;2050;5049;123;5172;97,62
3545159;Saltinho;2050;6486;1130;7616;85,16
3545209;Salto;2050;119845;849;120694;99,3
3545308;Salto de Pirapora;2050;38030;9722;47752;79,64
3545407;Salto Grande;2050;9025;511;9536;94,64
3545506;Sandovalina;2050;4653;278;4931;94,36
3545605;Santa Adélia;2050;13663;779;14442;94,61
3545704;Santa Albertina;2050;4417;325;4742;93,15
3545803;Santa Bárbara d'Oeste;2050;181946;1440;183386;99,21
3546009;Santa Branca;2050;12245;1637;13882;88,21
3546108;Santa Clara d'Oeste;2050;1523;183;1706;89,27
3546207;Santa Cruz da Conceição;2050;4045;267;4312;93,81
3546256;Santa Cruz da Esperança;2050;1567;612;2179;71,91
3546306;Santa Cruz das Palmeiras;2050;37034;653;37687;98,27
3546405;Santa Cruz do Rio Pardo;2050;44997;2166;47163;95,41
3546504;Santa Ernestina;2050;5076;149;5225;97,15
3546603;Santa Fé do Sul;2050;28092;1151;29243;96,06
3546702;Santa Gertrudes;2050;32654;351;33005;98,94
3546801;Santa Isabel;2050;52470;7405;59875;87,63
3546900;Santa Lucia;2050;8673;262;8935;97,07
3547007;Santa Maria da Serra;2050;7227;336;7563;95,56
3547106;Santa Mercedes;2050;2655;88;2743;96,79
3547205;Santana da Ponte Pensa;2050;971;145;1116;87,01
3547304;Santana de Parnaíba;2050;189874;0;189874;100
3547403;Santa Rita d'Oeste;2050;1680;166;1846;91,01
3547502;Santa Rita do Passa Quatro;2050;22977;1060;24037;95,59
3547601;Santa Rosa do Viterbo;2050;25374;527;25901;97,97
3547650;Santa Salete;2050;1108;111;1219;90,89
3547700;Santo Anastácio;2050;18033;692;18725;96,3
3547809;Santo André;2050;660182;0;660182;100
3547908;Santo Antonio da Alegria;2050;5108;1370;6478;78,85
3548005;Santo Antonio da Posse;2050;24520;462;24982;98,15
3548054;Santo Antonio do Aracanguá;2050;8069;296;8365;96,46
3548104;Santo Antonio do Jardim;2050;4301;1088;5389;79,81
3548203;Santo Antonio do Pinhal;2050;5990;711;6701;89,39
3548302;Santo Expedito;2050;3007;77;3084;97,5
3548401;Santópolis do Aguapeí;2050;4898;97;4995;98,06
3548500;Santos;2050;426062;319;426381;99,93
3548609;São Bento do Sapucaí;2050;6127;3796;9923;61,75
3548708;São Bernardo do Campo;2050;804697;11792;816489;98,56
3548807;São Caetano do Sul;2050;132729;0;132729;100
3548906;São Carlos;2050;237241;9898;247139;95,99
3549003;São Francisco;2050;2047;232;2279;89,82
3549102;São João da Boa Vista;2050;79632;1439;81071;98,23
3549201;São João das Duas Pontes;2050;1660;443;2103;78,93
3549250;São João de Iracema;2050;1692;53;1745;96,96
3549300;São João do Pau d'Alho;2050;1502;85;1587;94,64
3549409;São Joaquim da Barra;2050;51151;914;52065;98,24
3549508;São José da Bela Vista;2050;8758;440;9198;95,22
3549607;São José do Barreiro;2050;3724;284;4008;92,91
3549706;São José do Rio Pardo;2050;48918;1581;50499;96,87
3549805;São José do Rio Preto;2050;420472;27157;447629;93,93
3549904;São José dos Campos;2050;769289;15975;785264;97,97
3549953;São Lourenço da Serra;2050;17276;598;17874;96,65
3550001;São Luís do Paraitinga;2050;6408;4014;10422;61,49
3550100;São Manuel;2050;39038;403;39441;98,98
3550209;São Miguel Arcanjo;2050;31328;2764;34092;91,89
3550308;São Paulo;2050;12095576;109715;12205291;99,1
3550407;São Pedro;2050;33203;2522;35725;92,94
3550506;São Pedro do Turvo;2050;6553;787;7340;89,28
3550605;São Roque;2050;90812;971;91783;98,94
3550704;São Sebastião;2050;104445;1190;105635;98,87
3550803;São Sebastião da Grama;2050;9194;1834;11028;83,37
3550902;São Simão;2050;14180;520;14700;96,46
3551009;São Vicente;2050;384680;728;385408;99,81
3551108;Sarapuí;2050;10865;874;11739;92,55
3551207;Sarutaiá;2050;3469;202;3671;94,5
3551306;Sebastianópolis do Sul;2050;2876;218;3094;92,95
3551405;Serra Azul;2050;9834;3973;13807;71,22
3551504;Serrana;2050;50709;151;50860;99,7
3551603;Serra Negra;2050;22708;3088;25796;88,03
3551702;Sertãozinho;2050;128354;368;128722;99,71
3551801;Sete Barras;2050;11507;1608;13115;87,74
3551900;Severínia;2050;18234;574;18808;96,95
3552007;Silveiras;2050;4378;2299;6677;65,57
3552106;Socorro;2050;30287;7276;37563;80,63
3552205;Sorocaba;2050;699663;7194;706857;98,98
3552304;Sud Mennucci;2050;6647;1014;7661;86,76
3552403;Sumaré;2050;327811;3905;331716;98,82
3552502;Suzano;2050;321757;11740;333497;96,48
3552551;Suzanópolis;2050;3074;1531;4605;66,75
3552601;Tabapuã;2050;10659;688;11347;93,94
3552700;Tabatinga;2050;16112;693;16805;95,88
3552809;Taboão da Serra;2050;348470;0;348470;100
3552908;Taciba;2050;5820;405;6225;93,49
3553005;Taguaí;2050;11935;4725;16660;71,64
3553104;Taiaçu;2050;5581;217;5798;96,26
3553203;Taiúva;2050;5264;190;5454;96,52
3553302;Tambaú;2050;21575;981;22556;95,65
3553401;Tanabi;2050;21872;1415;23287;93,92
3553500;Tapiraí;2050;6493;1237;7730;84
3553609;Tapiratiba;2050;11162;337;11499;97,07
3553658;Taquaral;2050;2596;46;2642;98,26
3553708;Taquaritinga;2050;49623;1485;51108;97,09
3553807;Taquarituba;2050;22467;840;23307;96,4
3553856;Taquarivaí;2050;4650;2194;6844;67,94
3553906;Tarabaí;2050;7765;278;8043;96,54
3553955;Tarumã;2050;16183;761;16944;95,51
3554003;Tatuí;2050;136272;1697;137969;98,77
3554102;Taubaté;2050;315778;6558;322336;97,97
3554201;Tejupá;2050;4536;283;4819;94,13
3554300;Teodoro Sampaio;2050;19943;3110;23053;86,51
3554409;Terra Roxa;2050;9336;299;9635;96,9
3554508;Tietê;2050;42347;3388;45735;92,59
3554607;Timburi;2050;1977;261;2238;88,34
3554656;Torre de Pedra;2050;1923;345;2268;84,79
3554706;Torrinha;2050;8511;725;9236;92,15
3554755;Trabiju;2050;1786;70;1856;96,23
3554805;Tremembé;2050;48733;1618;50351;96,79
3554904;Três Fronteiras;2050;4801;368;5169;92,88
3554953;Tuiuti;2050;4520;2296;6816;66,31
3555000;Tupã;2050;53236;2225;55461;95,99
3555109;Tupi Paulista;2050;10461;2860;13321;78,53
3555208;Turiúba;2050;1437;149;1586;90,61
3555307;Turmalina;2050;1140;187;1327;85,91
3555356;Ubarana;2050;6528;450;6978;93,55
3555406;Ubatuba;2050;98662;2210;100872;97,81
3555505;Ubirajara;2050;3703;1165;4868;76,07
3555604;Uchôa;2050;8298;536;8834;93,93
3555703;União Paulista;2050;1720;235;1955;87,98
3555802;Urânia;2050;6620;593;7213;91,78
3555901;Uru;2050;1041;20;1061;98,11
3556008;Urupês;2050;11516;763;12279;93,79
3556107;Valentim Gentil;2050;13155;860;14015;93,86
3556206;Valinhos;2050;128379;4442;132821;96,66
3556305;Valparaíso;2050;24645;487;25132;98,06
3556354;Vargem;2050;9551;1279;10830;88,19
3556404;Vargem Grande do Sul;2050;41800;934;42734;97,81
3556453;Vargem Grande Paulista;2050;71933;0;71933;100
3556503;Várzea Paulista;2050;132008;0;132008;100
3556602;Vera Cruz;2050;8987;572;9559;94,02
3556701;Vinhedo;2050;85459;2773;88232;96,86
3556800;Viradouro;2050;18493;557;19050;97,08
3556909;Vista Alegre do Alto;2050;8591;289;8880;96,75
3556958;Vitória Brasil;2050;1493;103;1596;93,55
3557006;Votorantim;2050;124821;4949;129770;96,19
3557105;Votuporanga;2050;85996;2479;88475;97,2
3557154;Zacarias;2050;2433;195;2628;92,58
3557204;Chavantes;2050;11494;546;12040;95,47
3557303;Estiva Gerbi;2050;9231;2342;11573;79,76
